Id,MSSubClass,MSZoning,LotArea,Neighborhood,OverallQual,OverallCond,YearBuilt,GrLivArea,1stFlrSF,2ndFlrSF,GrLivArea,FullBath,HalfBath,GarageType,GarageYrBlt,GarageFinish,GarageCars
1461,20,RH,11622,NAmes,5,6,1961,896,896,0,896,1,0,Attchd,1961.0,Unf,1.0
1462,20,RL,14267,NAmes,6,6,1958,1329,1329,0,1329,1,1,Attchd,1958.0,Unf,1.0
1463,60,RL,13830,Gilbert,5,5,1997,1629,928,701,1629,2,1,Attchd,1997.0,Fin,2.0
1464,60,RL,9978,Gilbert,6,6,1998,1604,926,678,1604,2,1,Attchd,1998.0,Fin,2.0
1465,120,RL,5005,StoneBr,8,5,1992,1280,1280,0,1280,2,0,Attchd,1992.0,RFn,2.0
1466,60,RL,10000,Gilbert,6,5,1993,1655,763,892,1655,2,1,Attchd,1993.0,Fin,2.0
1467,20,RL,7980,Gilbert,6,7,1992,1187,1187,0,1187,2,0,Attchd,1992.0,Fin,2.0
1468,60,RL,8402,Gilbert,6,5,1998,1465,789,676,1465,2,1,Attchd,1998.0,Fin,2.0
1469,20,RL,10176,Gilbert,7,5,1990,1341,1341,0,1341,1,1,Attchd,1990.0,Unf,2.0
1470,20,RL,8400,NAmes,4,5,1970,882,882,0,882,1,0,Attchd,1970.0,Fin,2.0
1471,120,RH,5858,NAmes,7,5,1999,1337,1337,0,1337,2,0,Attchd,1999.0,Fin,2.0
1472,160,RM,1680,BrDale,6,5,1971,987,483,504,987,1,1,Detchd,1971.0,Unf,1.0
1473,160,RM,1680,BrDale,5,5,1971,1092,525,567,1092,1,1,Detchd,1997.0,Unf,1.0
1474,160,RL,2280,NPkVill,6,6,1975,1456,855,601,1456,2,1,Attchd,1975.0,Unf,2.0
1475,120,RL,2280,NPkVill,7,6,1975,836,836,0,836,1,0,Attchd,1975.0,Unf,1.0
1476,60,RL,12858,NridgHt,9,5,2009,2334,1627,707,2334,2,1,Attchd,2009.0,Fin,3.0
1477,20,RL,12883,NridgHt,8,5,2009,1544,1544,0,1544,2,0,Attchd,2009.0,RFn,3.0
1478,20,RL,11520,NridgHt,9,5,2005,1698,1698,0,1698,2,0,Attchd,2005.0,Fin,3.0
1479,20,RL,14122,NridgHt,8,5,2005,1822,1822,0,1822,2,0,Attchd,2005.0,RFn,3.0
1480,20,RL,14300,NridgHt,9,5,2003,2696,2696,0,2696,2,1,Attchd,2003.0,Fin,3.0
1481,60,RL,13650,NridgHt,8,5,2002,2250,1687,563,2250,2,1,Attchd,2002.0,Fin,3.0
1482,120,RL,7132,NridgHt,8,5,2006,1370,1370,0,1370,2,0,Attchd,2006.0,RFn,2.0
1483,20,RL,18494,Gilbert,6,5,2005,1324,1324,0,1324,2,0,Attchd,2005.0,Fin,2.0
1484,120,RL,3203,Blmngtn,7,5,2006,1145,1145,0,1145,2,0,Attchd,2006.0,Fin,2.0
1485,80,RL,13300,Gilbert,7,5,2004,1374,744,630,1374,2,1,BuiltIn,2004.0,Fin,2.0
1486,60,RL,8577,Gilbert,7,5,2004,1733,847,886,1733,2,1,BuiltIn,2004.0,Fin,2.0
1487,60,RL,17433,NoRidge,8,5,1998,2475,1645,830,2475,2,1,Attchd,1998.0,Fin,3.0
1488,20,RL,8987,Somerst,8,5,2005,1595,1595,0,1595,2,0,Attchd,2005.0,RFn,3.0
1489,20,FV,9215,Somerst,7,5,2009,1218,1218,0,1218,2,0,Attchd,2009.0,RFn,2.0
1490,20,FV,10440,Somerst,6,5,2005,1468,1468,0,1468,2,0,Attchd,2005.0,Fin,2.0
1491,60,RL,11920,SawyerW,7,5,2004,1659,831,828,1659,2,1,Attchd,2004.0,RFn,2.0
1492,30,RH,9800,SawyerW,5,5,1920,1012,1012,0,1012,1,0,Detchd,1920.0,Unf,1.0
1493,20,RL,15410,Sawyer,6,6,1974,1494,1494,0,1494,2,0,Attchd,1974.0,Fin,2.0
1494,60,RL,13143,NoRidge,8,5,1993,2349,1251,1098,2349,2,1,Attchd,1993.0,RFn,3.0
1495,60,RL,11134,NoRidge,8,5,1992,2225,1402,823,2225,2,1,Attchd,1992.0,RFn,3.0
1496,120,FV,4835,Somerst,7,5,2004,1488,1488,0,1488,2,0,Attchd,2004.0,Fin,2.0
1497,160,FV,3515,Somerst,7,5,2004,1680,840,840,1680,2,1,Attchd,2004.0,RFn,2.0
1498,160,FV,3215,Somerst,7,5,2004,1200,600,600,1200,2,1,Detchd,2004.0,RFn,2.0
1499,160,FV,2544,Somerst,7,5,2004,1200,600,600,1200,2,1,Detchd,2004.0,RFn,2.0
1500,160,FV,2544,Somerst,6,5,2005,1236,600,636,1236,2,1,Detchd,2005.0,RFn,2.0
1501,160,FV,2980,Somerst,6,5,2000,1512,756,756,1512,2,1,Detchd,2000.0,Unf,2.0
1502,160,FV,2403,Somerst,7,5,2003,1080,530,550,1080,2,1,Attchd,2003.0,RFn,2.0
1503,20,FV,12853,Somerst,8,5,2010,1418,1418,0,1418,1,1,Attchd,2010.0,RFn,3.0
1504,60,FV,7379,Somerst,8,5,2000,1848,975,873,1848,2,1,Attchd,2000.0,RFn,2.0
1505,20,FV,8000,Somerst,7,5,2002,1492,1492,0,1492,2,0,Attchd,2002.0,RFn,2.0
1506,20,RL,10456,NWAmes,6,6,1967,1829,1829,0,1829,2,0,Attchd,1967.0,RFn,2.0
1507,60,RL,10791,NWAmes,6,5,1993,2495,1280,1215,2495,2,1,Attchd,1993.0,Unf,2.0
1508,50,RL,18837,NWAmes,6,5,1978,1891,1287,604,1891,3,0,Attchd,1978.0,RFn,2.0
1509,60,RL,9600,NWAmes,6,6,1971,1645,930,715,1645,1,2,Attchd,1971.0,RFn,2.0
1510,20,RL,9600,NAmes,5,5,1966,1232,1232,0,1232,1,1,Attchd,1966.0,RFn,2.0
1511,20,RL,9900,NAmes,5,5,1966,1209,1209,0,1209,1,0,Attchd,1966.0,RFn,2.0
1512,20,RL,9680,NAmes,5,6,1967,1510,1510,0,1510,2,0,Attchd,1967.0,RFn,2.0
1513,80,RL,10600,NAmes,6,5,1964,1775,1131,644,1775,2,0,Attchd,1964.0,Unf,2.0
1514,90,RL,13260,NAmes,5,6,1962,1728,1728,0,1728,2,0,,,,0.0
1515,50,RL,9724,NAmes,5,7,1952,2461,1929,532,2461,2,0,Detchd,1994.0,Unf,2.0
1516,50,RL,17360,NAmes,6,6,1949,1556,1019,537,1556,2,0,Attchd,1949.0,Unf,2.0
1517,85,RL,11380,NAmes,6,8,1966,1128,1128,0,1128,1,0,Attchd,1966.0,Unf,1.0
1518,90,RL,8267,NAmes,5,5,1958,1604,1604,0,1604,2,0,Attchd,1958.0,Unf,2.0
1519,20,RL,8197,NAmes,7,5,2003,1480,1480,0,1480,2,0,Attchd,2003.0,RFn,2.0
1520,20,RL,8050,NAmes,5,5,1959,1143,1143,0,1143,1,0,Attchd,1959.0,RFn,1.0
1521,20,RL,10725,NAmes,5,5,1959,1206,1206,0,1206,1,0,Attchd,1959.0,RFn,1.0
1522,20,RL,10032,NAmes,6,5,1959,1580,1580,0,1580,1,1,Attchd,1956.0,Unf,2.0
1523,50,RL,8382,NAmes,4,5,1956,1337,832,505,1337,1,0,Attchd,1956.0,Unf,1.0
1524,20,RL,10950,NAmes,5,7,1952,1064,1064,0,1064,1,0,Detchd,1952.0,Unf,1.0
1525,20,RL,10895,NAmes,5,6,1955,972,972,0,972,1,0,Attchd,1955.0,Unf,1.0
1526,190,RL,13587,NAmes,5,5,1958,988,988,0,988,1,0,Attchd,1958.0,Unf,1.0
1527,30,RL,7898,NAmes,4,7,1920,985,985,0,985,1,0,Detchd,1989.0,Unf,2.0
1528,50,RL,8064,NAmes,6,8,1948,1224,816,408,1224,1,0,Detchd,1950.0,Unf,1.0
1529,20,RL,7635,NAmes,5,6,1960,1175,1175,0,1175,1,1,Detchd,1960.0,RFn,2.0
1530,20,RL,9760,NAmes,6,7,1963,1395,1395,0,1395,1,0,Attchd,1963.0,RFn,2.0
1531,50,RM,4800,OldTown,4,5,1900,1844,1157,687,1844,1,0,Basment,1900.0,Unf,1.0
1532,30,RM,4485,OldTown,5,7,1920,936,936,0,936,1,0,,,,0.0
1533,20,RM,5805,OldTown,5,7,1957,1347,1347,0,1347,1,0,Detchd,1957.0,Unf,2.0
1534,45,RM,6900,OldTown,6,7,1938,1251,827,424,1251,1,0,Detchd,1938.0,Unf,1.0
1535,50,RM,11851,OldTown,5,7,1948,1633,1027,606,1633,1,0,Detchd,1948.0,Unf,1.0
1536,50,RM,8239,OldTown,5,6,1920,1245,1060,185,1245,1,0,Detchd,1962.0,Unf,1.0
1537,30,RM,9656,OldTown,2,2,1923,832,832,0,832,1,0,Detchd,1928.0,Unf,2.0
1538,70,RM,9600,OldTown,8,9,1900,1566,930,636,1566,2,0,Detchd,1930.0,Unf,1.0
1539,70,RM,9000,OldTown,8,9,1890,2268,1157,1111,2268,3,0,Detchd,2003.0,Unf,2.0
1540,190,RM,9045,OldTown,5,3,1910,2256,1128,1128,2256,2,0,,,,0.0
1541,70,RM,10560,OldTown,6,7,1922,1470,868,602,1470,1,1,Detchd,1970.0,Unf,2.0
1542,50,RM,5830,BrkSide,5,6,1950,1612,1030,582,1612,1,1,Detchd,1950.0,Unf,1.0
1543,75,RL,7793,BrkSide,7,7,1922,2068,1160,908,2068,1,1,Detchd,1928.0,Unf,1.0
1544,30,RM,5000,BrkSide,4,7,1925,765,765,0,765,1,0,Detchd,1926.0,Unf,1.0
1545,50,RM,6000,BrkSide,6,7,1939,1132,608,524,1132,1,0,Detchd,1939.0,Unf,1.0
1546,50,RM,6000,BrkSide,6,6,1940,1196,848,348,1196,1,1,Detchd,1973.0,Unf,2.0
1547,50,RM,6360,BrkSide,5,6,1942,1453,955,498,1453,1,1,Detchd,1942.0,Unf,1.0
1548,50,RM,6000,BrkSide,6,7,1948,1416,780,636,1416,1,1,Detchd,1948.0,Unf,1.0
1549,50,RM,6240,BrkSide,5,7,1936,1040,548,492,1040,1,0,Detchd,1979.0,Fin,2.0
1550,50,RM,6240,BrkSide,5,5,1930,1536,928,608,1536,2,0,Detchd,1930.0,Unf,2.0
1551,30,RM,6120,OldTown,6,5,1923,1068,1068,0,1068,1,0,Detchd,1923.0,Unf,1.0
1552,50,RM,8094,OldTown,4,5,1915,1962,888,1074,1962,1,1,Detchd,1915.0,Unf,2.0
1553,70,RM,12900,OldTown,6,8,1912,1560,780,780,1560,1,1,,,,0.0
1554,70,RM,3068,OldTown,6,8,1920,1324,662,662,1324,1,0,Detchd,1920.0,Unf,1.0
1555,20,RL,15263,ClearCr,5,5,1959,1675,1675,0,1675,2,0,Attchd,1959.0,Unf,1.0
1556,50,RL,10632,ClearCr,5,3,1917,1224,725,499,1224,1,1,Detchd,1917.0,Unf,1.0
1557,190,RL,9900,SWISU,5,4,1915,1392,1212,180,1392,1,0,,,,0.0
1558,50,RL,6001,SWISU,6,5,1940,919,600,319,919,1,0,Detchd,1940.0,Unf,1.0
1559,70,C (all),6449,SWISU,4,1,1907,1884,942,942,1884,1,1,,,,0.0
1560,190,RH,6048,SWISU,5,7,1910,1680,936,744,1680,2,0,Detchd,1910.0,Unf,2.0
1561,90,RL,10773,Sawyer,4,3,1967,1832,1832,0,1832,2,0,,,,0.0
1562,20,RL,7800,Sawyer,5,7,1966,892,892,0,892,1,0,Detchd,1966.0,Unf,1.0
1563,20,RL,7832,Sawyer,5,5,1968,864,864,0,864,1,0,Detchd,1969.0,Unf,1.0
1564,90,RL,7424,Sawyer,5,5,1978,1373,1373,0,1373,1,0,Attchd,1978.0,Fin,2.0
1565,60,RL,11227,Sawyer,5,5,1968,1440,720,720,1440,1,1,Attchd,1968.0,Unf,2.0
1566,20,RL,20062,ClearCr,7,7,1977,1483,1483,0,1483,1,1,Attchd,1977.0,RFn,2.0
1567,30,RL,9259,Sawyer,4,4,1927,756,756,0,756,1,0,Detchd,1945.0,Unf,2.0
1568,60,RL,17082,ClearCr,6,5,1978,1981,1117,864,1981,2,1,Attchd,1978.0,Fin,2.0
1569,50,RL,18600,Edwards,3,4,1938,1610,1052,558,1610,2,0,Attchd,1938.0,RFn,1.0
1570,20,RL,11479,Edwards,6,7,1950,1074,1074,0,1074,1,0,Attchd,1987.0,Unf,1.0
1571,50,RL,9350,Edwards,4,6,1947,1531,1169,0,1531,1,0,Detchd,1947.0,Unf,1.0
1572,20,RL,9525,Edwards,5,7,1954,1172,1172,0,1172,1,0,Attchd,1954.0,Fin,1.0
1573,20,RL,17485,Edwards,7,5,2009,1508,1508,0,1508,1,0,Attchd,2009.0,RFn,2.0
1574,20,RL,11200,Edwards,5,3,1964,1298,1298,0,1298,2,0,Detchd,1964.0,Unf,2.0
1575,20,RL,11980,SawyerW,7,5,1987,1433,1433,0,1433,1,1,Attchd,1987.0,RFn,2.0
1576,60,RL,12361,SawyerW,6,7,1993,1802,964,838,1802,2,1,2Types,2000.0,RFn,4.0
1577,20,RL,7360,CollgCr,7,5,2010,1222,1222,0,1222,2,0,Attchd,2009.0,RFn,2.0
1578,50,RL,14235,SawyerW,6,8,1900,1445,831,614,1445,2,0,Detchd,1957.0,Unf,2.0
1579,85,RL,11105,CollgCr,5,5,1996,965,965,0,965,1,0,Attchd,1998.0,Unf,2.0
1580,60,RL,9337,CollgCr,7,5,1997,1692,892,800,1692,2,1,Attchd,1997.0,RFn,2.0
1581,20,RL,15240,CollgCr,5,8,1977,1026,1026,0,1026,1,1,Attchd,1977.0,Unf,1.0
1582,20,RL,7480,CollgCr,5,6,1972,876,876,0,876,1,0,Detchd,1977.0,Unf,2.0
1583,20,RL,10389,CollgCr,8,5,2003,1978,1978,0,1978,2,1,Attchd,2003.0,RFn,3.0
1584,60,RL,9375,CollgCr,7,5,1997,2098,1044,1054,2098,2,1,Attchd,1997.0,Fin,2.0
1585,120,RM,4435,CollgCr,6,5,2003,848,848,0,848,1,0,Attchd,2003.0,Fin,2.0
1586,30,RL,8777,Edwards,3,6,1945,640,640,0,640,1,0,Detchd,1945.0,Unf,1.0
1587,20,RL,8842,Edwards,5,6,1954,992,992,0,992,1,0,Detchd,1954.0,Unf,1.0
1588,20,RL,10044,Edwards,5,6,1968,1196,1196,0,1196,1,0,Attchd,1968.0,RFn,1.0
1589,50,RL,11792,Edwards,4,5,1948,1120,792,328,1120,1,0,Detchd,1956.0,Unf,2.0
1590,80,RL,6305,Edwards,6,6,1975,1096,1096,0,1096,1,0,Detchd,1975.0,Unf,1.0
1591,20,RL,6410,Edwards,4,5,1958,960,960,0,960,1,0,,,,0.0
1592,30,RL,4853,SWISU,5,6,1924,1296,1296,0,1296,2,0,Detchd,1979.0,Unf,1.0
1593,30,RL,7890,SWISU,6,6,1939,856,856,0,856,1,0,Detchd,1939.0,Unf,2.0
1594,90,RH,7200,SWISU,4,6,1967,2650,862,1788,2650,3,0,,,,0.0
1595,50,RL,9839,SWISU,5,2,1931,1666,894,772,1666,1,0,,,,0.0
1596,50,RL,10452,Crawfor,7,6,1941,2133,1225,908,2133,1,1,Attchd,1941.0,Unf,1.0
1597,90,RL,15600,Crawfor,5,6,1950,2177,1102,1075,2177,2,1,Detchd,1950.0,Unf,2.0
1598,80,RL,19645,Crawfor,7,6,1994,1652,896,756,1652,2,1,BuiltIn,1994.0,RFn,2.0
1599,120,RM,3907,Blueste,8,6,1989,1034,1034,0,1034,1,0,Attchd,1989.0,Fin,2.0
1600,120,RM,3907,Blueste,8,5,1989,1191,1191,0,1191,2,0,Attchd,1989.0,Unf,2.0
1601,30,RM,8154,IDOTRR,2,5,1941,540,540,0,540,1,0,Detchd,1951.0,Unf,1.0
1602,50,RM,9140,IDOTRR,6,5,1921,1107,727,380,1107,1,0,Detchd,1950.0,Unf,1.0
1603,30,C (all),8712,IDOTRR,4,7,1896,952,952,0,952,1,0,Detchd,1896.0,RFn,1.0
1604,120,RM,3811,Crawfor,8,5,2004,1646,1646,0,1646,2,0,Attchd,2004.0,Fin,2.0
1605,60,RL,11050,Mitchel,8,5,1998,1916,1036,880,1916,2,1,Attchd,1998.0,Unf,3.0
1606,80,RL,9620,Mitchel,6,7,1977,1285,1285,0,1285,2,0,Attchd,1977.0,Unf,2.0
1607,90,RL,12760,Mitchel,6,5,1976,2048,2048,0,2048,3,0,2Types,1976.0,Unf,2.0
1608,20,RL,11896,Timber,7,5,2008,1346,1346,0,1346,2,0,Attchd,2008.0,Fin,3.0
1609,20,RL,9803,Timber,7,5,2009,1214,1214,0,1214,2,0,Attchd,2010.0,RFn,2.0
1610,60,RL,9802,Timber,5,5,2006,1444,744,700,1444,2,1,BuiltIn,2007.0,Fin,2.0
1611,20,RL,15300,Mitchel,5,5,1965,1264,1264,0,1264,1,0,Attchd,1965.0,Unf,2.0
1612,20,RL,10114,Mitchel,5,5,2004,1430,1430,0,1430,2,0,Attchd,2004.0,RFn,2.0
1613,20,RL,11875,Mitchel,5,5,1999,1344,1344,0,1344,2,0,Attchd,2001.0,Unf,2.0
1614,120,RM,2394,MeadowV,5,6,1973,945,945,0,945,1,0,Attchd,1973.0,RFn,1.0
1615,160,RM,1476,MeadowV,4,7,1970,1092,546,546,1092,1,1,,,,0.0
1616,160,RM,1900,MeadowV,4,4,1970,1092,546,546,1092,1,1,,,,0.0
1617,160,RM,1890,MeadowV,4,6,1972,1092,546,546,1092,1,1,Attchd,1972.0,Unf,1.0
1618,20,RL,6953,Mitchel,5,7,1971,874,874,0,874,1,0,Detchd,1971.0,Unf,1.0
1619,20,RL,12887,Mitchel,5,7,1984,833,833,0,833,1,0,Attchd,1984.0,Unf,2.0
1620,90,RL,7700,Mitchel,5,2,1985,2432,1216,1216,2432,4,2,Attchd,1985.0,Unf,2.0
1621,60,RL,10475,Mitchel,5,5,1991,1274,624,650,1274,1,1,Detchd,1993.0,Unf,2.0
1622,50,RL,10544,Mitchel,5,5,1969,1479,864,615,1479,2,0,Attchd,1969.0,Fin,1.0
1623,20,RL,9892,Mitchel,8,5,1994,1803,1803,0,1803,2,1,Attchd,1994.0,Unf,2.0
1624,60,RL,12961,Mitchel,6,5,1993,1797,1152,645,1797,2,1,Attchd,1993.0,Fin,2.0
1625,20,RL,13008,NAmes,6,5,1956,882,882,0,882,1,0,Attchd,1956.0,Unf,1.0
1626,20,RL,10200,NAmes,6,5,1974,1434,1434,0,1434,2,0,Attchd,1974.0,RFn,2.0
1627,60,RL,10179,Gilbert,6,5,1997,1608,945,663,1608,2,1,Attchd,1997.0,Fin,2.0
1628,60,RL,11792,Gilbert,8,5,2003,2283,1008,1275,2283,2,1,BuiltIn,2003.0,Fin,3.0
1629,80,RL,8400,Gilbert,7,5,1996,1628,958,670,1628,2,1,BuiltIn,1996.0,Fin,2.0
1630,120,RL,7296,StoneBr,8,5,2004,2522,2522,0,2522,2,0,Attchd,2004.0,Fin,2.0
1631,120,RL,7380,StoneBr,8,5,1998,1478,1478,0,1478,2,0,Attchd,1998.0,Fin,2.0
1632,120,RL,8013,StoneBr,8,5,1995,1734,1734,0,1734,2,0,Attchd,1995.0,RFn,2.0
1633,80,RL,8923,Gilbert,7,5,1998,1382,751,631,1382,2,1,BuiltIn,1998.0,Fin,2.0
1634,60,RL,7500,Gilbert,6,5,1998,1636,952,684,1636,2,1,Attchd,1998.0,Fin,2.0
1635,60,RL,8803,Gilbert,6,5,1994,1516,707,809,1516,2,1,Attchd,1994.0,Fin,2.0
1636,20,RL,7250,Gilbert,6,5,1993,1190,1190,0,1190,2,0,Attchd,1993.0,Unf,2.0
1637,60,RL,11900,Gilbert,5,6,1977,1934,946,988,1934,2,1,Attchd,1977.0,Unf,2.0
1638,60,RL,13250,NWAmes,7,6,1978,2050,1154,896,2050,2,1,Attchd,1978.0,RFn,2.0
1639,20,RL,10928,NWAmes,6,6,1978,1671,1671,0,1671,2,0,Attchd,1978.0,RFn,2.0
1640,60,RL,12388,NWAmes,7,7,1980,2673,1539,1134,2673,2,1,BuiltIn,1980.0,RFn,2.0
1641,20,RL,11088,NWAmes,6,5,1978,1707,1707,0,1707,2,0,Attchd,1978.0,Fin,2.0
1642,60,FV,7000,Somerst,7,5,2003,1884,1016,868,1884,2,1,Attchd,2003.0,RFn,2.0
1643,60,FV,7500,Somerst,8,5,2000,1874,1058,816,1874,2,1,Attchd,2000.0,Fin,2.0
1644,60,FV,8470,Somerst,8,5,2002,1811,972,839,1811,2,1,Attchd,2002.0,RFn,2.0
1645,20,RL,9373,NWAmes,5,7,1975,1621,1621,0,1621,2,0,Attchd,1975.0,RFn,2.0
1646,20,RL,10140,NWAmes,6,6,1974,1116,1116,0,1116,2,0,Attchd,1974.0,RFn,2.0
1647,20,RL,11050,NWAmes,7,5,1975,1193,1193,0,1193,2,0,Attchd,1975.0,Unf,2.0
1648,20,RL,7830,NAmes,5,5,1970,1180,1180,0,1180,1,1,Attchd,1970.0,RFn,2.0
1649,20,RL,8510,NAmes,5,7,1971,1050,1050,0,1050,1,1,Attchd,1971.0,Unf,1.0
1650,20,RL,7038,NAmes,4,6,1970,864,864,0,864,1,0,Detchd,2001.0,Unf,2.0
1651,20,RL,9000,NAmes,4,7,1971,864,864,0,864,1,0,Detchd,1986.0,Unf,2.0
1652,160,RM,1680,BrDale,6,5,1973,987,483,504,987,1,1,Detchd,1973.0,Unf,1.0
1653,160,RM,1680,BrDale,6,6,1972,987,483,504,987,1,1,Detchd,1972.0,Unf,1.0
1654,160,RL,2308,NPkVill,6,5,1976,1548,804,744,1548,2,1,Detchd,1976.0,RFn,2.0
1655,120,RL,2280,NPkVill,7,5,1975,1055,1055,0,1055,2,0,Attchd,1975.0,RFn,2.0
1656,160,RL,2349,NPkVill,6,5,1977,1456,855,601,1456,2,1,Attchd,1977.0,Unf,2.0
1657,160,RL,2364,NPkVill,6,5,1978,1548,804,744,1548,2,1,Detchd,1978.0,Unf,2.0
1658,160,RL,2364,NPkVill,6,5,1978,1456,855,601,1456,2,1,Attchd,1978.0,Fin,2.0
1659,120,RL,2104,NPkVill,7,6,1976,836,836,0,836,1,0,Attchd,1976.0,Unf,1.0
1660,20,RL,10710,NAmes,5,7,1966,1120,1120,0,1120,1,0,Attchd,1966.0,RFn,2.0
1661,60,RL,14257,NridgHt,9,5,2007,2772,1794,978,2772,3,1,BuiltIn,2007.0,Fin,3.0
1662,60,RL,12350,NridgHt,9,5,2009,2690,1365,1325,2690,2,1,Attchd,2009.0,RFn,3.0
1663,20,RL,12350,NridgHt,9,5,2008,2020,2020,0,2020,2,0,Attchd,2008.0,RFn,3.0
1664,20,RL,13693,NridgHt,10,5,2007,2674,2674,0,2674,2,1,Attchd,2007.0,Fin,3.0
1665,20,RL,11578,NridgHt,9,5,2008,1736,1736,0,1736,2,0,Attchd,2008.0,RFn,3.0
1666,20,RL,16870,NridgHt,8,5,2004,1782,1782,0,1782,2,0,Attchd,2004.0,Fin,3.0
1667,60,RL,23303,NridgHt,8,5,2007,2520,1508,1012,2520,2,1,BuiltIn,2007.0,Fin,3.0
1668,20,RL,10367,NridgHt,9,5,2008,1743,1743,0,1743,2,0,Attchd,2008.0,RFn,3.0
1669,20,RL,10872,NridgHt,9,5,2006,1531,1531,0,1531,2,0,Attchd,2006.0,Fin,3.0
1670,20,RL,13514,NridgHt,9,5,2008,1808,1808,0,1808,2,0,Attchd,2008.0,Fin,3.0
1671,20,RL,12878,NridgHt,7,5,2003,1760,1760,0,1760,2,0,Attchd,2003.0,Fin,2.0
1672,20,RL,15274,NridgHt,9,5,2003,2452,2452,0,2452,2,0,Attchd,2003.0,Fin,3.0
1673,60,RL,13262,NridgHt,8,5,2003,2400,1105,1295,2400,3,1,BuiltIn,2003.0,Fin,3.0
1674,20,RL,9658,NridgHt,8,5,2006,1606,1606,0,1606,2,0,Attchd,2006.0,RFn,3.0
1675,120,RL,6904,NridgHt,6,5,2005,1358,1358,0,1358,2,0,Attchd,2005.0,RFn,2.0
1676,120,RL,5122,NridgHt,6,5,2005,1306,1306,0,1306,2,0,Attchd,2005.0,RFn,2.0
1677,120,RL,10307,NridgHt,7,5,2007,1358,1358,0,1358,2,0,Attchd,2008.0,RFn,2.0
1678,20,RL,14836,NridgHt,10,5,2004,2492,2492,0,2492,2,1,Attchd,2004.0,Fin,3.0
1679,20,RL,15262,NridgHt,8,5,2003,2200,2200,0,2200,2,1,Attchd,2003.0,Fin,3.0
1680,120,RL,7390,NridgHt,9,5,2008,1884,1884,0,1884,2,0,Attchd,2008.0,Fin,2.0
1681,120,RL,6472,NridgHt,9,5,2008,1456,1456,0,1456,2,0,Attchd,2008.0,RFn,2.0
1682,20,RL,16770,NridgHt,8,5,2002,1712,1712,0,1712,2,0,Attchd,2002.0,RFn,3.0
1683,120,RL,3480,NridgHt,7,5,2003,1405,1405,0,1405,2,0,Attchd,2003.0,RFn,2.0
1684,60,RL,10928,Gilbert,7,5,2005,1456,728,728,1456,2,1,Attchd,2005.0,Fin,2.0
1685,60,RL,8918,Gilbert,6,5,2005,1490,745,745,1490,2,1,Attchd,2005.0,Fin,2.0
1686,120,RL,3182,Blmngtn,7,5,2005,1220,1220,0,1220,2,0,Attchd,2005.0,Fin,2.0
1687,80,RL,9434,Gilbert,7,5,2004,1374,744,630,1374,2,1,BuiltIn,2004.0,Fin,2.0
1688,60,RL,7984,Gilbert,7,5,2004,1630,868,762,1630,2,1,BuiltIn,2004.0,Fin,2.0
1689,60,RL,10125,Gilbert,7,5,2004,1594,846,748,1594,2,1,Attchd,2004.0,Fin,2.0
1690,60,RL,8965,Gilbert,7,5,2003,1489,806,683,1489,2,1,Attchd,2003.0,Fin,2.0
1691,60,RL,8174,Gilbert,7,5,2003,1342,698,644,1342,2,1,Attchd,2003.0,Fin,2.0
1692,60,RL,12891,Gilbert,8,5,2002,2004,878,1126,2004,2,1,BuiltIn,2002.0,Fin,3.0
1693,80,RL,9734,Gilbert,7,5,2004,1374,744,630,1374,2,1,BuiltIn,2004.0,Fin,2.0
1694,60,RL,8433,Gilbert,6,5,2000,1514,819,695,1514,2,1,Attchd,2000.0,Fin,2.0
1695,80,RL,7750,Gilbert,7,5,1999,1430,774,656,1430,2,1,BuiltIn,1999.0,RFn,2.0
1696,60,RL,15896,Gilbert,7,5,1999,2312,1223,1089,2312,2,1,BuiltIn,1999.0,Fin,3.0
1697,80,RL,7848,Gilbert,7,6,1999,1430,774,656,1430,2,1,BuiltIn,1999.0,Fin,2.0
1698,60,RL,12720,NoRidge,8,5,2000,2687,1466,1221,2687,2,1,BuiltIn,2000.0,RFn,3.0
1699,20,RL,10750,NoRidge,8,5,1994,2063,2063,0,2063,2,0,Attchd,1994.0,Fin,3.0
1700,60,RL,9085,NoRidge,7,5,1995,2061,1094,967,2061,2,1,Attchd,1995.0,Fin,2.0
1701,60,RL,11692,NoRidge,8,5,1993,2232,1215,1017,2232,2,1,Attchd,1993.0,RFn,2.0
1702,20,RL,11194,Somerst,8,5,2008,1696,1696,0,1696,2,0,Attchd,2008.0,RFn,3.0
1703,20,RL,10206,Somerst,8,5,2008,1658,1658,0,1658,2,1,Attchd,2008.0,Fin,3.0
1704,20,RL,10130,Somerst,8,5,2007,1702,1702,0,1702,2,0,Attchd,2007.0,RFn,3.0
1705,20,RL,9139,Somerst,8,5,2006,1432,1432,0,1432,2,0,Attchd,2006.0,Fin,2.0
1706,20,RL,11128,Somerst,9,5,2005,2490,2490,0,2490,2,0,Attchd,2005.0,Fin,3.0
1707,20,FV,7993,Somerst,7,5,2008,1436,1436,0,1436,2,0,Attchd,2008.0,Fin,2.0
1708,20,FV,8640,Somerst,7,5,2008,1402,1402,0,1402,2,0,Attchd,2008.0,RFn,2.0
1709,20,FV,12606,Somerst,9,5,2007,1530,1530,0,1530,2,0,Attchd,2008.0,RFn,3.0
1710,20,FV,7500,Somerst,8,5,2006,1448,1448,0,1448,2,0,Attchd,2006.0,RFn,2.0
1711,60,FV,10603,Somerst,8,5,2006,1795,909,886,1795,2,1,Attchd,2006.0,Fin,3.0
1712,20,FV,8125,Somerst,8,5,2008,1836,1836,0,1836,2,0,Attchd,2009.0,Fin,2.0
1713,20,FV,10625,Somerst,7,5,2006,1662,1662,0,1662,2,0,Attchd,2006.0,RFn,3.0
1714,20,FV,8736,Somerst,7,5,2003,1553,1553,0,1553,2,0,Attchd,2003.0,RFn,2.0
1715,60,FV,8127,Somerst,7,5,2003,1653,812,841,1653,2,1,Attchd,2003.0,RFn,2.0
1716,20,RL,9605,SawyerW,7,6,2007,1218,1218,0,1218,1,1,Detchd,2007.0,RFn,2.0
1717,20,RL,7500,SawyerW,7,5,2006,1141,1141,0,1141,1,1,Detchd,2006.0,RFn,2.0
1718,20,RL,7500,SawyerW,6,5,2004,1158,1158,0,1158,1,1,,,,0.0
1719,60,RL,10628,SawyerW,7,5,2004,1812,871,941,1812,2,1,BuiltIn,2004.0,RFn,2.0
1720,20,RL,10141,SawyerW,8,5,2004,1512,1512,0,1512,2,0,Attchd,2004.0,RFn,3.0
1721,20,RL,13072,SawyerW,7,5,2004,1114,1114,0,1114,1,1,Detchd,2005.0,Unf,2.0
1722,20,RL,13072,SawyerW,5,5,2004,1114,1114,0,1114,1,1,,,,0.0
1723,20,RL,12450,SawyerW,5,5,2003,1114,1114,0,1114,2,0,Detchd,2004.0,Unf,2.0
1724,20,RL,7328,SawyerW,7,5,2008,1450,1450,0,1450,2,0,Attchd,2008.0,RFn,3.0
1725,60,RL,11492,SawyerW,7,5,1996,2122,913,1209,2122,2,1,Attchd,1997.0,RFn,2.0
1726,60,RL,7703,SawyerW,6,6,1992,1730,833,897,1730,2,1,Attchd,1992.0,RFn,2.0
1727,120,RL,7175,SawyerW,6,5,1990,1332,1332,0,1332,2,0,Attchd,1990.0,RFn,2.0
1728,60,RL,9109,SawyerW,7,5,1994,1540,754,786,1540,2,1,Attchd,1994.0,RFn,2.0
1729,60,RL,10274,SawyerW,6,7,1986,1400,698,702,1400,2,1,Attchd,1986.0,RFn,2.0
1730,90,RL,8250,SawyerW,6,7,1981,1882,964,918,1882,2,0,Attchd,1981.0,Unf,2.0
1731,20,RL,9750,Sawyer,5,5,1962,980,980,0,980,1,0,Detchd,1969.0,Unf,2.0
1732,20,RL,8499,Sawyer,5,6,1961,864,864,0,864,1,0,Detchd,1982.0,Unf,2.0
1733,20,RL,9079,Sawyer,5,5,1961,864,864,0,864,1,0,Attchd,1961.0,Unf,1.0
1734,20,RL,9316,Sawyer,5,5,1965,1020,1020,0,1020,2,0,Attchd,1965.0,Unf,1.0
1735,20,RL,7791,Sawyer,5,8,1963,912,912,0,912,1,0,Attchd,1963.0,RFn,1.0
1736,20,RL,7150,Sawyer,5,6,1962,912,912,0,912,1,0,Attchd,1962.0,Unf,1.0
1737,20,RL,15676,Veenker,8,8,1980,2014,2014,0,2014,2,0,Attchd,1980.0,RFn,3.0
1738,60,RL,11949,NoRidge,7,8,1991,1755,975,780,1755,2,1,Attchd,1991.0,Unf,2.0
1739,160,FV,2880,Somerst,7,5,2004,3005,1376,1629,3005,2,1,BuiltIn,2004.0,Fin,3.0
1740,120,FV,3830,Somerst,6,5,2008,1726,1726,0,1726,2,1,Attchd,2008.0,Fin,2.0
1741,120,FV,4217,Somerst,6,5,2008,1256,1256,0,1256,1,1,Attchd,2008.0,Fin,2.0
1742,160,FV,2998,Somerst,6,5,2000,1512,756,756,1512,2,1,Detchd,2000.0,Unf,2.0
1743,160,FV,3768,Somerst,7,5,1999,1452,713,739,1452,2,1,Detchd,1999.0,Unf,2.0
1744,20,RL,14694,Veenker,8,9,1977,1694,1694,0,1694,2,0,Attchd,1977.0,Fin,2.0
1745,20,RL,15417,Veenker,7,5,1981,1740,1740,0,1740,1,1,Attchd,1981.0,RFn,2.0
1746,80,RL,9600,Veenker,8,5,1976,2499,1487,1012,2499,2,1,Attchd,1976.0,Unf,2.0
1747,60,RL,12732,NWAmes,7,6,1974,2067,1285,782,2067,2,1,Attchd,1974.0,RFn,2.0
1748,60,RL,10400,NWAmes,6,7,1967,2640,1271,1369,2640,2,1,Attchd,1967.0,RFn,2.0
1749,20,RL,9600,NWAmes,5,5,1969,1336,1336,0,1336,2,0,Attchd,1969.0,RFn,2.0
1750,20,RL,9000,NWAmes,6,5,1969,1216,1216,0,1216,1,0,Attchd,1969.0,Unf,1.0
1751,60,RL,13774,NWAmes,7,7,1977,2288,1316,972,2288,1,2,Attchd,1977.0,RFn,2.0
1752,20,RL,7130,NAmes,5,6,1967,864,864,0,864,1,0,Attchd,1967.0,Fin,1.0
1753,20,RL,9600,NAmes,5,5,1967,1568,1568,0,1568,1,1,Attchd,1967.0,Unf,2.0
1754,60,RL,9600,NWAmes,7,5,1974,2061,1165,896,2061,2,1,Attchd,1974.0,RFn,2.0
1755,85,RL,16500,NWAmes,6,5,1971,1320,1320,0,1320,2,0,Attchd,1971.0,RFn,2.0
1756,20,RL,7436,NAmes,4,7,1960,894,894,0,894,1,0,Detchd,1988.0,Unf,2.0
1757,20,RL,8125,NAmes,5,7,1959,864,864,0,864,1,0,Detchd,1960.0,Unf,1.0
1758,20,RL,9450,NAmes,4,5,1957,1362,1362,0,1362,1,0,Attchd,1982.0,RFn,3.0
1759,20,RL,13495,NAmes,5,6,1956,1728,1728,0,1728,2,0,Detchd,1956.0,Unf,2.0
1760,20,RL,9350,NAmes,5,6,1961,1313,1313,0,1313,1,1,Attchd,1961.0,RFn,2.0
1761,20,RL,10500,NAmes,5,5,1964,1292,1292,0,1292,1,1,Detchd,1964.0,Unf,2.0
1762,60,RL,8970,NAmes,5,6,1965,2140,825,1315,2140,2,1,Attchd,1965.0,Fin,2.0
1763,80,RL,11475,NAmes,6,6,1961,1576,1576,0,1576,1,0,BuiltIn,1961.0,Fin,2.0
1764,20,RL,9768,NAmes,5,5,1955,960,960,0,960,1,0,Attchd,1955.0,RFn,1.0
1765,20,RL,9900,NAmes,6,5,1967,1691,1691,0,1691,1,0,Attchd,1967.0,Unf,2.0
1766,20,RL,10573,NAmes,6,6,1961,1453,1453,0,1453,2,0,Attchd,1961.0,RFn,2.0
1767,20,RL,14695,NAmes,6,8,1966,1567,1567,0,1567,2,0,Attchd,1966.0,Unf,2.0
1768,20,RL,8760,NAmes,5,7,1956,1144,1144,0,1144,1,0,Attchd,1956.0,RFn,1.0
1769,20,RL,12285,NAmes,7,6,1960,1329,1329,0,1329,1,1,Attchd,1960.0,Unf,2.0
1770,20,RL,9240,NAmes,6,8,1959,988,988,0,988,2,0,Attchd,1959.0,Unf,1.0
1771,20,RL,8750,NAmes,5,5,1956,1202,1202,0,1202,1,0,Attchd,1956.0,RFn,1.0
1772,20,RL,8750,NAmes,5,5,1955,1382,1382,0,1382,1,0,Attchd,1955.0,Unf,1.0
1773,20,RL,10400,NAmes,4,5,1956,1200,1200,0,1200,1,0,Attchd,1956.0,Unf,1.0
1774,90,RL,9482,NAmes,5,4,1958,1866,1866,0,1866,2,0,Detchd,1958.0,Unf,2.0
1775,20,RL,8128,NAmes,6,7,1954,1062,1062,0,1062,1,0,Attchd,1954.0,Unf,1.0
1776,20,RL,13070,NAmes,5,5,1951,1112,1112,0,1112,1,0,Basment,1951.0,Unf,2.0
1777,30,RL,8480,NAmes,5,6,1945,793,793,0,793,1,0,Detchd,1945.0,Unf,1.0
1778,20,RL,7626,NAmes,5,8,1952,1031,1031,0,1031,1,0,Attchd,1952.0,Unf,1.0
1779,20,RL,9533,NAmes,5,5,1953,1210,1210,0,1210,1,1,Attchd,1953.0,Fin,1.0
1780,60,RL,11419,NAmes,7,7,1948,1527,801,726,1527,1,1,Attchd,1948.0,Unf,2.0
1781,20,RL,9600,NAmes,5,6,1950,1200,1200,0,1200,1,0,Attchd,1950.0,Fin,1.0
1782,20,RL,5470,OldTown,3,5,1958,792,792,0,792,1,0,Attchd,1958.0,Unf,1.0
1783,60,RL,10800,OldTown,5,7,1939,1352,676,676,1352,2,0,Detchd,1939.0,Unf,2.0
1784,70,RL,8146,OldTown,4,8,1900,1039,717,322,1039,1,0,Detchd,1940.0,Unf,1.0
1785,30,RL,10230,OldTown,5,7,1925,1078,1078,0,1078,1,0,Detchd,1987.0,Unf,1.0
1786,50,RL,10410,OldTown,4,5,1915,2377,1313,0,2377,2,0,Detchd,1954.0,Unf,2.0
1787,70,RL,7200,OldTown,7,9,1910,1690,930,760,1690,2,0,Detchd,2008.0,Unf,2.0
1788,30,RL,5400,OldTown,2,5,1940,599,599,0,599,1,0,,,,0.0
1789,30,RL,10800,OldTown,5,7,1920,846,846,0,846,1,0,Detchd,1980.0,Fin,2.0
1790,30,RL,10800,OldTown,3,5,1890,725,725,0,725,1,1,Detchd,1959.0,Unf,1.0
1791,90,RL,9671,NAmes,6,5,1969,2544,1248,1296,2544,2,2,Attchd,1969.0,RFn,3.0
1792,20,RL,10143,NAmes,6,7,1963,1380,1380,0,1380,1,1,Attchd,1963.0,Unf,1.0
1793,20,RL,11500,NAmes,6,4,1967,1040,1040,0,1040,1,0,Attchd,1967.0,RFn,2.0
1794,20,RL,8010,NAmes,6,9,1958,951,951,0,951,1,0,Detchd,1985.0,Unf,2.0
1795,20,RL,10454,NAmes,6,6,1957,1105,1105,0,1105,1,0,Detchd,1957.0,Unf,1.0
1796,20,RL,9000,NAmes,6,6,1958,1142,1142,0,1142,1,0,Basment,1958.0,RFn,1.0
1797,50,RL,8064,NAmes,6,5,1950,1133,765,368,1133,1,0,Detchd,1989.0,Unf,2.0
1798,20,RL,7350,NAmes,5,6,1958,1041,1041,0,1041,1,0,Attchd,1958.0,RFn,1.0
1799,20,RL,7200,NAmes,5,7,1952,732,732,0,732,1,0,Detchd,1952.0,Unf,1.0
1800,80,RL,8000,NAmes,5,5,1959,1183,1183,0,1183,1,0,Attchd,1959.0,RFn,1.0
1801,50,RL,10800,NAmes,4,7,1949,1461,832,629,1461,2,0,Detchd,1949.0,Unf,1.0
1802,50,RL,8064,NAmes,6,7,1948,1495,1064,0,1495,1,0,Detchd,1994.0,Unf,2.0
1803,60,RL,7570,NAmes,6,5,1964,1806,993,813,1806,1,1,Attchd,1964.0,Unf,2.0
1804,90,RL,8604,NAmes,5,7,1978,941,941,0,941,1,0,Attchd,1978.0,Unf,2.0
1805,20,RL,7936,NAmes,6,6,1963,1045,1045,0,1045,1,0,Attchd,1963.0,RFn,1.0
1806,50,RM,4080,OldTown,6,8,1935,1378,861,517,1378,1,0,Detchd,1920.0,Unf,1.0
1807,90,RM,10307,OldTown,6,5,1910,1944,972,972,1944,2,0,Detchd,1920.0,Unf,2.0
1808,50,RM,15660,OldTown,5,8,1910,1306,810,496,1306,1,1,Detchd,1959.0,Unf,2.0
1809,70,RM,9900,OldTown,5,8,1910,1464,764,700,1464,2,0,,,,0.0
1810,70,RM,6406,OldTown,5,6,1939,1558,868,690,1558,1,1,Detchd,1939.0,Unf,2.0
1811,190,RM,7627,OldTown,4,6,1920,1701,1101,600,1701,2,0,,,,0.0
1812,50,RM,10134,OldTown,5,5,1910,1447,801,646,1447,1,0,,,,0.0
1813,50,RM,6000,OldTown,5,7,1950,1328,768,560,1328,1,1,Detchd,1950.0,Unf,1.0
1814,30,RM,7404,OldTown,4,6,1920,861,861,0,861,1,0,Detchd,1920.0,Unf,2.0
1815,30,RM,5925,OldTown,2,4,1940,612,612,0,612,1,0,Detchd,1965.0,Unf,1.0
1816,30,RM,8520,OldTown,5,8,1923,792,792,0,792,1,0,Detchd,1963.0,Unf,1.0
1817,70,RM,9600,OldTown,4,4,1910,1510,833,677,1510,2,0,Detchd,1974.0,Unf,2.0
1818,70,RM,8400,OldTown,6,7,1900,2007,1090,917,2007,2,0,Detchd,1930.0,Unf,1.0
1819,70,RM,3600,OldTown,6,7,1917,1288,664,624,1288,1,0,Attchd,1917.0,Unf,1.0
1820,30,C (all),3300,OldTown,4,3,1910,816,816,0,816,1,0,,,,0.0
1821,50,RM,5400,OldTown,6,6,1920,1480,1044,0,1480,1,0,Detchd,1920.0,Unf,1.0
1822,70,RM,9720,OldTown,6,7,1910,1521,780,741,1521,1,0,Detchd,1950.0,Unf,3.0
1823,30,C (all),9392,IDOTRR,3,3,1900,797,797,0,797,1,0,,,,0.0
1824,30,RL,6615,BrkSide,6,6,1923,1432,1432,0,1432,1,0,BuiltIn,1923.0,Unf,1.0
1825,70,RL,4960,BrkSide,5,7,1930,1654,1001,653,1654,2,0,Detchd,1955.0,Unf,1.0
1826,50,RM,6000,BrkSide,5,5,1924,1142,822,320,1142,1,0,Attchd,1924.0,Fin,1.0
1827,30,RM,6120,BrkSide,5,6,1925,995,995,0,995,1,0,Detchd,1926.0,Unf,1.0
1828,50,RM,6120,BrkSide,5,6,1938,1582,994,588,1582,2,0,Detchd,1938.0,Unf,1.0
1829,30,RM,8635,BrkSide,5,5,1925,1072,1072,0,1072,1,0,Detchd,1982.0,Unf,5.0
1830,70,RM,8094,OldTown,6,6,1915,1768,1048,720,1768,2,0,Detchd,1930.0,Unf,2.0
1831,70,RM,9928,OldTown,7,8,1915,1944,1272,672,1944,2,0,Detchd,1915.0,Unf,1.0
1832,90,RM,3000,OldTown,5,1,1922,2128,1088,1040,2128,2,0,,,,0.0
1833,70,RM,6876,IDOTRR,6,5,1927,1930,1146,784,1930,2,0,Attchd,1927.0,Unf,1.0
1834,70,RM,5775,OldTown,6,7,1915,1427,741,686,1427,1,0,Attchd,1915.0,Unf,1.0
1835,190,RM,5852,OldTown,7,5,1902,1864,978,886,1864,2,1,,,,0.0
1836,50,RM,5160,IDOTRR,6,6,1927,1666,1204,462,1666,1,0,Detchd,1927.0,Unf,1.0
1837,85,RM,5160,IDOTRR,4,6,1923,892,892,0,892,1,0,,,,0.0
1838,190,RM,10320,IDOTRR,6,7,1915,1403,754,649,1403,1,1,Detchd,1915.0,Unf,1.0
1839,20,RL,4280,Sawyer,4,9,1946,704,704,0,704,1,0,CarPort,1946.0,Unf,1.0
1840,90,RL,10800,Edwards,5,5,1987,1200,1200,0,1200,3,0,,,,0.0
1841,90,RL,10547,Edwards,5,5,1978,1152,1152,0,1152,2,0,Detchd,1960.0,Unf,1.0
1842,50,RL,9780,Edwards,5,3,1934,1112,687,425,1112,2,0,Detchd,1934.0,Unf,1.0
1843,20,RL,11625,Sawyer,5,6,1967,1052,1052,0,1052,1,1,Attchd,1984.0,Fin,1.0
1844,85,RL,8014,Sawyer,6,5,1978,1034,1034,0,1034,1,0,Basment,1978.0,Fin,2.0
1845,80,RL,15400,Sawyer,5,5,1961,1774,904,611,1774,2,0,Attchd,1961.0,Unf,1.0
1846,80,RL,15312,Sawyer,6,5,1960,1138,1138,0,1138,1,0,Attchd,1960.0,RFn,2.0
1847,80,RL,15584,ClearCr,5,5,1956,2071,2071,0,2071,1,1,Attchd,1956.0,Unf,1.0
1848,20,RL,9000,Sawyer,2,2,1947,660,660,0,660,1,0,,,,0.0
1849,20,RL,15635,Edwards,4,5,1954,1383,1383,0,1383,1,0,Attchd,1980.0,Unf,2.0
1850,20,RL,9571,Edwards,5,5,1956,1073,1073,0,1073,1,0,Attchd,1956.0,Unf,1.0
1851,60,RL,9350,Edwards,6,7,1946,1639,892,747,1639,1,1,Detchd,1946.0,Unf,1.0
1852,20,RL,7440,Edwards,5,6,1954,1089,1089,0,1089,1,0,Detchd,1954.0,RFn,1.0
1853,120,RL,4235,Edwards,5,5,1984,1049,1049,0,1049,2,0,Attchd,1984.0,Fin,1.0
1854,80,RL,10778,SawyerW,7,6,1990,1061,1061,0,1061,1,1,Attchd,1990.0,Unf,2.0
1855,80,RL,19255,SawyerW,6,5,1983,1338,1338,0,1338,1,1,Attchd,1983.0,Unf,2.0
1856,60,RL,10560,SawyerW,7,5,1993,1879,1079,800,1879,2,1,Attchd,1993.0,RFn,2.0
1857,70,RL,26400,SawyerW,5,7,1880,2016,1288,728,2016,1,0,Attchd,1900.0,Unf,2.0
1858,90,RL,7018,SawyerW,5,5,1979,2228,1114,1114,2228,2,0,Detchd,1979.0,Unf,2.0
1859,90,RL,7018,SawyerW,5,5,1979,1535,1535,0,1535,2,0,Attchd,1979.0,Unf,2.0
1860,90,RL,7040,SawyerW,5,5,1979,1229,1229,0,1229,0,2,Detchd,1979.0,Unf,2.0
1861,90,RL,7007,SawyerW,5,5,1979,1513,1513,0,1513,2,0,Attchd,1979.0,Unf,2.0
1862,90,RL,11855,SawyerW,7,5,2000,2787,1168,1619,2787,4,2,BuiltIn,2000.0,Fin,4.0
1863,90,RL,7939,SawyerW,7,5,2000,2787,1168,1619,2787,4,2,BuiltIn,2000.0,Fin,4.0
1864,90,RL,7976,SawyerW,7,5,2000,2787,1168,1619,2787,4,2,BuiltIn,2000.0,Fin,4.0
1865,20,RL,10933,CollgCr,9,5,2009,1680,1680,0,1680,1,1,Attchd,2009.0,Fin,3.0
1866,20,RL,10816,CollgCr,9,5,2008,1720,1720,0,1720,2,0,Attchd,2008.0,RFn,3.0
1867,20,RL,9178,CollgCr,8,5,2008,1468,1468,0,1468,2,0,Attchd,2008.0,RFn,3.0
1868,20,RL,11422,CollgCr,8,5,2007,1838,1838,0,1838,2,0,Attchd,2007.0,RFn,2.0
1869,20,RL,6762,CollgCr,7,5,2007,1290,1290,0,1290,2,0,Attchd,2007.0,RFn,2.0
1870,20,RL,10324,CollgCr,8,5,2008,1254,1254,0,1254,2,0,Attchd,2008.0,RFn,3.0
1871,20,RL,11645,CollgCr,8,5,2005,1498,1498,0,1498,2,0,Attchd,2005.0,Fin,3.0
1872,60,RL,11646,CollgCr,6,5,2005,1422,704,718,1422,2,1,Attchd,2005.0,Fin,2.0
1873,60,RL,16698,ClearCr,7,5,1992,1759,944,815,1759,2,1,Attchd,1992.0,Unf,2.0
1874,20,RL,9757,CollgCr,5,7,1994,990,990,0,990,1,0,Attchd,1995.0,RFn,1.0
1875,20,RL,14753,CollgCr,7,5,1998,1463,1463,0,1463,2,0,Attchd,1998.0,Fin,2.0
1876,60,RL,8750,CollgCr,6,5,1998,1772,928,844,1772,2,1,Attchd,1998.0,RFn,2.0
1877,20,RL,10739,CollgCr,7,5,2002,1444,1444,0,1444,2,0,Attchd,2002.0,RFn,2.0
1878,20,RL,11166,CollgCr,7,5,2001,1492,1492,0,1492,2,0,Attchd,2001.0,RFn,2.0
1879,20,RL,16269,CollgCr,5,5,1978,907,907,0,907,1,0,Attchd,1978.0,Unf,1.0
1880,20,RL,6950,CollgCr,5,7,1979,914,914,0,914,1,0,Attchd,1979.0,Unf,2.0
1881,20,RL,11664,CollgCr,7,5,2002,1611,1611,0,1611,2,0,Attchd,2002.0,RFn,3.0
1882,60,RL,12334,CollgCr,8,5,2003,2184,1068,1116,2184,2,1,BuiltIn,2003.0,RFn,2.0
1883,60,RL,8749,CollgCr,7,5,2002,1725,840,885,1725,2,1,Attchd,2002.0,RFn,2.0
1884,60,RL,11250,CollgCr,7,5,2001,1870,944,926,1870,2,1,Attchd,2001.0,RFn,2.0
1885,20,RL,15750,CollgCr,8,5,1999,1513,1513,0,1513,2,0,Attchd,1999.0,Fin,2.0
1886,20,RL,12782,CollgCr,8,5,2002,1828,1828,0,1828,2,0,Attchd,2002.0,Fin,2.0
1887,20,RL,8750,CollgCr,7,5,1997,1417,1417,0,1417,2,0,Attchd,1997.0,Unf,2.0
1888,20,RL,10200,CollgCr,8,5,2007,1602,1602,0,1602,2,0,Attchd,2007.0,RFn,3.0
1889,60,RL,11069,CollgCr,6,5,2007,1396,608,788,1396,2,1,BuiltIn,2007.0,Fin,2.0
1890,20,RL,10682,Edwards,4,6,1960,1149,1149,0,1149,1,0,2Types,1968.0,Fin,1.0
1891,180,RM,3675,Edwards,6,5,2005,1072,1072,0,1072,1,0,Basment,2005.0,Fin,2.0
1892,20,RL,6410,Edwards,4,5,1959,876,876,0,876,1,0,Detchd,1959.0,Unf,1.0
1893,20,RL,11767,Edwards,5,5,1950,1368,1368,0,1368,1,0,Attchd,1950.0,RFn,1.0
1894,90,RL,10926,Edwards,5,5,1959,1678,1678,0,1678,2,0,,,,0.0
1895,20,RL,11767,Edwards,5,5,1956,1560,1560,0,1560,1,0,Attchd,1956.0,Unf,1.0
1896,50,RL,8212,Edwards,5,6,1941,1298,854,444,1298,1,0,Detchd,1940.0,Unf,1.0
1897,50,RH,6300,SWISU,5,4,1938,1268,832,436,1268,1,1,Basment,1938.0,Unf,1.0
1898,70,RL,5707,SWISU,6,6,1935,1242,647,595,1242,1,1,Detchd,1926.0,Unf,1.0
1899,30,RL,8574,Crawfor,6,8,1916,1232,1232,0,1232,1,0,Detchd,1916.0,Unf,2.0
1900,70,RL,7155,Crawfor,7,8,1918,1228,628,600,1228,1,0,Detchd,1918.0,Unf,1.0
1901,50,RL,13680,Crawfor,5,6,1940,1567,840,727,1567,1,1,Detchd,1961.0,Unf,2.0
1902,20,RL,14680,Crawfor,5,4,1960,1273,1273,0,1273,1,0,Attchd,1960.0,Unf,1.0
1903,90,RL,8145,Crawfor,7,6,1940,2480,1240,1240,2480,2,1,Detchd,1940.0,Unf,2.0
1904,20,RL,9100,Crawfor,5,6,1954,1112,1112,0,1112,1,0,Attchd,1954.0,Unf,1.0
1905,20,RL,13339,Crawfor,6,6,1960,1561,1561,0,1561,2,0,Attchd,1960.0,Fin,2.0
1906,50,RL,15600,Crawfor,5,7,1949,1523,986,537,1523,2,0,Attchd,1949.0,Unf,1.0
1907,20,RL,17500,Crawfor,6,5,1954,1906,1906,0,1906,1,1,Basment,1954.0,Unf,2.0
1908,160,RM,1733,Blueste,6,6,1980,1032,516,516,1032,1,0,Detchd,1980.0,Unf,2.0
1909,160,RM,1488,Blueste,6,6,1980,1229,561,668,1229,1,1,Attchd,1980.0,Fin,2.0
1910,160,RM,1612,Blueste,6,6,1980,1229,561,668,1229,1,1,Attchd,1980.0,Fin,2.0
1911,80,RL,13607,Crawfor,6,6,1986,1982,1182,800,1982,2,1,BuiltIn,1986.0,Fin,2.0
1912,20,RL,17597,Crawfor,7,9,1971,2365,2365,0,2365,2,0,Attchd,1971.0,Fin,2.0
1913,70,RM,8660,IDOTRR,5,6,1900,2168,928,928,2168,2,0,Detchd,1998.0,Unf,2.0
1914,30,C (all),10200,IDOTRR,4,6,1925,572,572,0,572,1,0,Detchd,1940.0,Unf,1.0
1915,120,RM,3843,Crawfor,8,5,2007,1648,1648,0,1648,2,0,Attchd,2007.0,Fin,2.0
1916,30,,21780,IDOTRR,2,4,1910,810,810,0,810,1,0,Detchd,1975.0,Unf,1.0
1917,60,RL,10125,Mitchel,8,5,2000,2052,1040,1012,2052,2,1,BuiltIn,2000.0,Fin,3.0
1918,85,RL,9750,Mitchel,6,6,1977,926,926,0,926,1,0,Attchd,1977.0,Unf,1.0
1919,85,RL,9360,Mitchel,6,7,1977,1287,1287,0,1287,1,1,Attchd,1977.0,RFn,2.0
1920,20,RL,11070,Mitchel,5,5,1991,1595,1595,0,1595,2,0,Detchd,1991.0,Unf,2.0
1921,20,RL,13438,Timber,9,5,2008,2036,2036,0,2036,2,0,Attchd,2008.0,Fin,3.0
1922,20,RL,14463,Timber,9,5,2008,1641,1641,0,1641,2,0,Attchd,2008.0,Fin,3.0
1923,60,RL,9839,Timber,6,8,1980,2237,1375,862,2237,2,1,BuiltIn,1980.0,Fin,2.0
1924,80,RL,14419,Timber,7,5,1987,1479,1479,0,1479,2,1,Attchd,1987.0,Fin,2.0
1925,60,RL,9157,Timber,7,5,2003,2014,1072,942,2014,2,1,Attchd,2003.0,Fin,2.0
1926,20,RL,12633,Timber,9,5,2007,1978,1978,0,1978,2,0,Attchd,2007.0,Fin,3.0
1927,20,RL,12518,Mitchel,5,7,1968,1008,1008,0,1008,1,0,Attchd,1968.0,Unf,1.0
1928,20,RL,13383,Mitchel,5,5,1969,1404,1404,0,1404,2,0,Attchd,1969.0,Unf,2.0
1929,85,RL,7689,Mitchel,5,8,1972,796,796,0,796,1,0,Detchd,1998.0,Unf,1.0
1930,80,RL,7706,Mitchel,6,5,1993,1091,1091,0,1091,1,0,Attchd,1993.0,Fin,1.0
1931,85,RL,7669,Mitchel,5,6,1992,883,883,0,883,1,0,Detchd,1998.0,Unf,2.0
1932,60,RL,10429,Mitchel,5,5,1992,1287,624,663,1287,1,1,Detchd,2001.0,Unf,2.0
1933,60,RL,10457,Mitchel,5,7,1969,1632,784,848,1632,1,1,Attchd,1969.0,RFn,2.0
1934,60,RL,8702,Gilbert,6,5,1997,1604,926,678,1604,2,1,Attchd,1997.0,Fin,2.0
1935,60,RL,8139,Gilbert,6,5,1995,1470,680,790,1470,2,1,BuiltIn,1995.0,Fin,2.0
1936,60,RL,9535,Gilbert,6,5,1998,1604,926,678,1604,2,1,Attchd,1998.0,Fin,2.0
1937,60,RL,15038,Gilbert,6,5,1996,1636,916,720,1636,2,1,Attchd,1996.0,Fin,2.0
1938,20,RL,14137,Gilbert,5,5,1996,1384,1384,0,1384,2,0,Attchd,1996.0,Unf,2.0
1939,120,RL,6264,StoneBr,8,5,1997,1682,1682,0,1682,1,1,Attchd,1997.0,Fin,2.0
1940,120,RL,5070,StoneBr,8,5,1992,1280,1280,0,1280,2,0,Attchd,1992.0,RFn,2.0
1941,60,RL,11184,Gilbert,6,5,1998,1633,932,701,1633,2,1,Attchd,1998.0,Fin,2.0
1942,60,RL,14067,Gilbert,6,5,1991,1709,851,858,1709,2,1,Attchd,1991.0,Fin,2.0
1943,120,RL,5950,StoneBr,8,5,1989,1337,1337,0,1337,2,0,Attchd,1989.0,RFn,2.0
1944,60,RL,13543,StoneBr,8,5,2005,2500,1168,1332,2500,3,1,BuiltIn,2005.0,Fin,3.0
1945,20,RL,15401,StoneBr,9,5,2004,1884,1884,0,1884,2,0,Attchd,2004.0,Fin,3.0
1946,20,RL,31220,Gilbert,6,2,1952,1474,1474,0,1474,1,0,Attchd,1952.0,Unf,2.0
1947,120,RL,8118,StoneBr,9,5,2007,1710,1710,0,1710,2,0,Attchd,2007.0,RFn,2.0
1948,20,RL,47280,Gilbert,6,5,1950,1488,1488,0,1488,2,1,Attchd,1950.0,RFn,2.0
1949,20,RL,12680,NWAmes,7,6,1988,1688,1688,0,1688,2,0,Attchd,1988.0,RFn,2.0
1950,20,RL,10825,NWAmes,7,7,1983,1260,1260,0,1260,2,0,Attchd,1983.0,Unf,2.0
1951,20,RL,18559,NWAmes,7,5,1978,2064,2064,0,2064,2,0,Attchd,1978.0,Fin,2.0
1952,20,RL,14450,NWAmes,7,5,1979,1782,1782,0,1782,2,0,Attchd,1979.0,Fin,2.0
1953,20,RL,13068,NWAmes,6,5,1976,1211,1211,0,1211,2,0,Attchd,1976.0,Fin,2.0
1954,60,RL,10400,NWAmes,7,6,1980,2044,1277,767,2044,2,1,Attchd,1980.0,Unf,2.0
1955,60,RL,9743,NWAmes,5,6,1969,1308,720,588,1308,1,1,Detchd,1969.0,Unf,2.0
1956,60,RL,12511,NWAmes,7,7,1978,2840,1420,1420,2840,2,1,Attchd,1978.0,Fin,4.0
1957,20,RL,10400,NWAmes,6,5,1976,1444,1444,0,1444,2,0,Attchd,1976.0,Unf,2.0
1958,60,RL,14311,NWAmes,8,5,1996,2340,1236,1104,2340,2,1,Attchd,1996.0,RFn,3.0
1959,90,RL,9000,NAmes,5,5,1974,1792,896,896,1792,2,2,Detchd,1982.0,Unf,2.0
1960,20,RL,10295,NAmes,4,6,1969,936,936,0,936,1,0,Attchd,1969.0,Unf,1.0
1961,20,RL,7560,NAmes,5,5,1971,864,864,0,864,1,0,Detchd,1977.0,Unf,2.0
1962,160,RM,1680,BrDale,6,5,1973,987,483,504,987,1,1,Detchd,1973.0,Unf,1.0
1963,160,RM,1890,BrDale,6,6,1972,987,483,504,987,1,1,Detchd,1975.0,Unf,1.0
1964,160,RM,1680,BrDale,5,5,1972,1302,630,672,1302,2,1,Detchd,1972.0,Unf,1.0
1965,160,RL,2308,NPkVill,6,6,1975,1456,855,601,1456,2,1,Attchd,1975.0,RFn,2.0
1966,120,RL,2529,NPkVill,7,6,1977,1055,1055,0,1055,2,0,Attchd,1977.0,Unf,2.0
1967,20,RL,12704,NridgHt,8,5,2007,1582,1582,0,1582,2,0,Attchd,2007.0,Fin,3.0
1968,20,RL,13693,NridgHt,8,5,2007,2464,2464,0,2464,2,1,Attchd,2007.0,Fin,3.0
1969,20,RL,14418,NridgHt,9,5,2007,1950,1950,0,1950,2,0,Attchd,2007.0,Fin,3.0
1970,60,RL,13418,NridgHt,9,5,2006,2748,1850,898,2748,2,1,BuiltIn,2006.0,Fin,3.0
1971,60,RL,12539,NridgHt,10,5,2005,2790,1632,1158,2790,2,1,BuiltIn,2005.0,Fin,4.0
1972,60,RL,12151,NridgHt,9,5,2005,2331,1414,917,2331,2,1,BuiltIn,2005.0,Fin,3.0
1973,60,RL,8899,NridgHt,8,5,2007,2088,948,1140,2088,2,1,BuiltIn,2007.0,Fin,3.0
1974,60,RL,10574,NridgHt,8,5,2004,2332,1170,1162,2332,2,1,BuiltIn,2004.0,Fin,3.0
1975,20,RL,12720,NridgHt,10,5,2003,2470,2470,0,2470,1,1,Attchd,2003.0,Fin,3.0
1976,20,RL,10845,NridgHt,8,5,2003,1575,1575,0,1575,2,0,Attchd,2003.0,Fin,3.0
1977,60,RL,16900,NridgHt,8,5,2001,2649,1515,1134,2649,2,1,Attchd,2001.0,Fin,3.0
1978,60,RL,16451,NridgHt,8,5,2003,2690,1804,886,2690,2,1,BuiltIn,2003.0,Fin,3.0
1979,120,RL,10110,NridgHt,9,5,2008,1866,1866,0,1866,2,0,Attchd,2008.0,Fin,3.0
1980,120,RL,12304,NridgHt,7,5,2005,1367,1367,0,1367,2,0,Attchd,2005.0,RFn,2.0
1981,120,RL,8232,NridgHt,9,5,2007,1800,1800,0,1800,2,0,Attchd,2008.0,RFn,3.0
1982,120,RL,6240,NridgHt,8,5,2006,1342,1342,0,1342,2,0,Attchd,2007.0,Fin,2.0
1983,120,RL,6240,NridgHt,8,5,2006,1342,1342,0,1342,2,0,Attchd,2007.0,RFn,2.0
1984,160,RL,2448,NridgHt,7,5,2003,1626,764,862,1626,2,1,BuiltIn,2003.0,RFn,2.0
1985,120,RL,3940,Blmngtn,7,5,2003,1455,1455,0,1455,2,0,Attchd,2003.0,Fin,3.0
1986,120,RM,3940,Blmngtn,7,5,2004,1576,1576,0,1576,2,0,Attchd,2004.0,RFn,3.0
1987,20,RL,3710,Blmngtn,7,5,2007,1246,1246,0,1246,2,0,Attchd,2007.0,Fin,2.0
1988,60,RL,9024,Gilbert,6,5,2004,1515,813,702,1515,2,1,Attchd,2004.0,Fin,2.0
1989,60,RL,8010,Gilbert,7,5,2002,1720,840,880,1720,2,1,BuiltIn,2002.0,Fin,2.0
1990,60,RL,8396,Gilbert,7,5,2003,1986,847,1139,1986,2,1,BuiltIn,2003.0,Fin,2.0
1991,120,RL,7301,NridgHt,7,6,2007,1358,1358,0,1358,2,0,Attchd,2008.0,RFn,2.0
1992,60,RL,8220,Gilbert,7,5,2000,1892,1008,884,1892,2,1,Attchd,2000.0,RFn,2.0
1993,60,RL,7750,Gilbert,7,5,2002,1414,707,707,1414,2,1,Attchd,2002.0,Fin,2.0
1994,60,RL,12460,Gilbert,7,5,1999,2322,1037,1285,2322,2,1,BuiltIn,1999.0,Fin,2.0
1995,60,RL,8390,Gilbert,7,5,1999,1651,873,778,1651,2,1,BuiltIn,1999.0,Fin,2.0
1996,75,RL,9660,NoRidge,8,5,1997,2199,1182,1017,2199,2,1,Attchd,1997.0,Fin,2.0
1997,60,RL,11000,NoRidge,9,5,2000,2172,1533,639,2172,2,1,BuiltIn,2000.0,RFn,3.0
1998,20,RL,11675,NoRidge,8,5,1998,2006,2006,0,2006,2,0,Attchd,1998.0,Fin,3.0
1999,60,RL,10990,NoRidge,7,5,1996,2125,1064,1061,2125,2,1,Attchd,1996.0,RFn,2.0
2000,60,RL,11929,NoRidge,8,7,1995,2501,1251,1250,2501,2,1,Attchd,1995.0,RFn,3.0
2001,60,RL,10010,NoRidge,7,5,1993,2197,1108,1089,2197,2,1,Attchd,1993.0,Fin,3.0
2002,20,RL,13253,Somerst,7,5,2006,1578,1578,0,1578,2,0,Attchd,2006.0,Unf,3.0
2003,60,RL,9801,Somerst,8,5,2007,1861,1341,520,1861,3,0,BuiltIn,2007.0,RFn,3.0
2004,60,RL,9428,Somerst,8,5,2007,1874,955,919,1874,2,1,Attchd,2007.0,Fin,3.0
2005,20,RL,10037,Somerst,8,5,2006,1460,1460,0,1460,2,0,Attchd,2006.0,Fin,2.0
2006,20,FV,8640,Somerst,8,5,2007,1372,1372,0,1372,2,0,Attchd,2008.0,RFn,2.0
2007,20,FV,10625,Somerst,8,5,2007,1660,1660,0,1660,2,0,Attchd,2007.0,Fin,3.0
2008,20,FV,7500,Somerst,7,5,2007,1218,1218,0,1218,2,0,Attchd,2008.0,Fin,2.0
2009,60,RL,10110,SawyerW,6,5,2003,1696,835,861,1696,2,1,Attchd,2003.0,RFn,2.0
2010,60,RL,12774,SawyerW,7,5,2003,1663,835,828,1663,2,1,Attchd,2003.0,RFn,2.0
2011,20,RL,13072,SawyerW,6,5,2005,1175,1175,0,1175,1,0,,,,0.0
2012,20,RL,9260,SawyerW,7,5,2007,1162,1162,0,1162,2,0,Attchd,2007.0,Fin,2.0
2013,60,RL,8453,SawyerW,6,5,1995,1609,754,855,1609,2,1,Attchd,1995.0,RFn,2.0
2014,60,RL,8480,SawyerW,6,5,1993,1680,886,794,1680,2,1,Attchd,1993.0,RFn,2.0
2015,60,RL,14565,SawyerW,7,5,1994,1657,832,825,1657,2,1,Attchd,1994.0,RFn,2.0
2016,60,RL,8450,SawyerW,6,5,2001,1677,827,850,1677,2,1,Attchd,2001.0,RFn,2.0
2017,60,RL,8285,SawyerW,7,5,1992,1737,844,893,1737,2,1,Attchd,1992.0,Fin,2.0
2018,20,RL,9100,Sawyer,5,5,1963,984,984,0,984,1,0,Attchd,1963.0,RFn,1.0
2019,20,RL,8100,Sawyer,5,8,1961,864,864,0,864,1,0,Detchd,1962.0,Unf,1.0
2020,190,RL,8450,Sawyer,5,5,1968,890,890,0,890,1,0,Detchd,1970.0,Unf,1.0
2021,20,RL,6360,Sawyer,5,5,1963,864,864,0,864,1,0,Attchd,1963.0,Unf,1.0
2022,20,RL,19508,Veenker,6,5,1974,1430,1430,0,1430,2,0,Attchd,1974.0,Unf,2.0
2023,50,RL,10759,Sawyer,5,4,1972,1641,1001,640,1641,2,0,Detchd,1972.0,Unf,2.0
2024,60,RL,9205,NoRidge,6,5,1990,2683,1364,1319,2683,2,1,Attchd,1990.0,RFn,2.0
2025,60,RL,11025,NoRidge,9,5,1993,2786,1827,959,2786,2,1,Attchd,1993.0,Fin,2.0
2026,120,FV,3435,Somerst,7,5,2004,1245,1245,0,1245,2,0,Attchd,2004.0,RFn,2.0
2027,160,FV,3180,Somerst,6,5,2005,1200,600,600,1200,2,1,Detchd,2005.0,RFn,2.0
2028,160,FV,3180,Somerst,7,5,2007,1392,703,689,1392,2,0,Detchd,2007.0,Unf,2.0
2029,160,FV,2280,Somerst,6,5,1999,1549,757,792,1549,2,1,Detchd,1999.0,Unf,2.0
2030,120,FV,4765,Somerst,9,5,2000,1638,1638,0,1638,2,0,Attchd,2000.0,Fin,2.0
2031,120,FV,4538,Somerst,9,5,2001,1310,1310,0,1310,1,1,Attchd,2001.0,RFn,2.0
2032,120,FV,4385,Somerst,9,5,2001,1419,1419,0,1419,1,1,Attchd,2001.0,Fin,2.0
2033,120,FV,4109,Somerst,9,5,1999,1557,1557,0,1557,2,0,Attchd,1999.0,RFn,2.0
2034,160,FV,2160,Somerst,7,5,1999,1404,684,720,1404,2,1,Detchd,1999.0,Unf,2.0
2035,60,FV,10646,Somerst,7,5,2001,1789,872,917,1789,2,1,Attchd,2001.0,Fin,2.0
2036,160,FV,2645,Somerst,8,5,1999,1586,962,624,1586,2,1,Detchd,1999.0,Unf,2.0
2037,160,FV,2645,Somerst,8,5,1999,1607,962,645,1607,2,1,Detchd,2000.0,Unf,2.0
2038,160,FV,3951,Somerst,10,5,1998,2393,1469,924,2393,2,1,Attchd,1998.0,Fin,2.0
2039,120,RL,11064,Veenker,8,5,1995,1239,1239,0,1239,1,1,Attchd,1995.0,Fin,2.0
2040,60,RL,24572,Veenker,9,3,1977,2944,1599,1345,2944,2,2,Attchd,1977.0,RFn,3.0
2041,20,RL,16280,Veenker,8,9,1976,1671,1671,0,1671,3,0,Attchd,1976.0,RFn,2.0
2042,60,FV,7500,Somerst,7,5,2002,1812,952,860,1812,2,1,Attchd,2002.0,RFn,2.0
2043,80,RL,11104,NWAmes,6,6,1969,1427,1427,0,1427,2,0,Attchd,1969.0,RFn,2.0
2044,20,RL,11050,NWAmes,6,5,1968,1740,1740,0,1740,1,1,Attchd,1968.0,RFn,2.0
2045,20,RL,15387,NWAmes,7,7,1967,1620,1620,0,1620,2,0,Attchd,1967.0,Unf,2.0
2046,90,RL,9750,NWAmes,5,6,1965,1625,1625,0,1625,2,0,Detchd,1965.0,Unf,2.0
2047,60,RL,8814,NAmes,5,6,1968,1464,732,732,1464,1,1,Attchd,1968.0,Unf,2.0
2048,20,RL,8125,NAmes,5,7,1965,925,925,0,925,1,0,Detchd,1978.0,Unf,2.0
2049,90,RL,11072,NAmes,5,5,1965,1728,1728,0,1728,2,0,Detchd,1987.0,Unf,2.0
2050,60,RL,13355,NWAmes,7,6,1971,1670,845,825,1670,1,1,Attchd,1971.0,Fin,2.0
2051,20,RL,7785,NAmes,5,5,1956,1014,1014,0,1014,1,0,Attchd,1956.0,RFn,1.0
2052,20,RL,9900,NAmes,5,5,1961,1114,1114,0,1114,1,0,Attchd,1961.0,RFn,2.0
2053,20,RL,11332,NAmes,5,7,1960,1118,1118,0,1118,1,0,Attchd,1960.0,RFn,1.0
2054,70,RL,4882,BrkSide,4,7,1937,906,453,453,906,1,0,Basment,1937.0,Unf,1.0
2055,20,RL,9600,NAmes,5,6,1960,1496,1496,0,1496,2,0,Attchd,1960.0,RFn,2.0
2056,20,RL,9600,NAmes,5,8,1950,1337,1337,0,1337,1,0,Attchd,1950.0,RFn,1.0
2057,20,RL,7584,NAmes,5,5,1953,1036,1036,0,1036,1,0,Attchd,1953.0,RFn,1.0
2058,60,RL,14670,NAmes,6,7,1966,1988,1104,884,1988,2,1,Attchd,1966.0,RFn,2.0
2059,20,RL,8856,NAmes,5,4,1957,1176,1176,0,1176,1,0,Attchd,1957.0,RFn,1.0
2060,20,RL,9840,NAmes,5,7,1959,1440,1440,0,1440,2,0,Attchd,1959.0,RFn,1.0
2061,20,RL,13200,NAmes,6,6,1958,1570,1570,0,1570,1,0,Attchd,1958.0,RFn,2.0
2062,20,RL,10425,NAmes,5,5,1956,1104,1104,0,1104,1,0,Attchd,1956.0,RFn,1.0
2063,20,RL,11556,NAmes,5,6,1952,882,882,0,882,1,0,Attchd,1952.0,Unf,1.0
2064,20,RL,9373,NAmes,5,6,1953,1152,1152,0,1152,1,1,Detchd,1971.0,Unf,2.0
2065,20,RL,12774,NAmes,5,5,1953,950,950,0,950,1,0,Detchd,1953.0,Unf,2.0
2066,20,RL,14250,NAmes,6,5,1957,1790,1790,0,1790,2,0,Attchd,1957.0,Fin,2.0
2067,20,RL,8838,NAmes,5,3,1957,1764,1764,0,1764,2,1,Attchd,1957.0,Fin,1.0
2068,90,RL,12436,NAmes,5,5,1957,1824,1824,0,1824,2,0,Detchd,1958.0,Unf,2.0
2069,20,RL,10122,OldTown,4,6,1948,869,869,0,869,1,0,Detchd,1948.0,Unf,1.0
2070,50,RL,7506,OldTown,5,8,1925,1159,747,412,1159,1,0,Detchd,1932.0,Unf,1.0
2071,30,RL,5400,OldTown,4,7,1940,672,672,0,672,1,0,Detchd,1997.0,Unf,1.0
2072,50,RL,10836,OldTown,5,5,1922,1436,1254,182,1436,1,0,Detchd,1968.0,Unf,4.0
2073,20,RL,10180,NAmes,5,6,1968,1044,1044,0,1044,1,1,Attchd,1990.0,Fin,2.0
2074,20,RL,11355,NAmes,7,7,1958,1312,1312,0,1312,1,1,Attchd,1958.0,RFn,2.0
2075,20,RL,12929,NAmes,6,6,1960,1081,1081,0,1081,1,0,CarPort,1960.0,Unf,1.0
2076,20,RL,7200,NAmes,5,7,1951,876,876,0,876,1,0,Detchd,1972.0,Unf,2.0
2077,20,RL,8000,NAmes,5,6,1959,1256,1256,0,1256,1,1,Attchd,1959.0,RFn,1.0
2078,20,RL,8000,NAmes,5,5,1962,1027,1027,0,1027,1,0,Attchd,1962.0,Unf,1.0
2079,50,RL,8064,NAmes,6,6,1948,1320,819,501,1320,2,0,Detchd,1994.0,Unf,2.0
2080,45,RL,6390,NAmes,6,7,1954,984,984,0,984,1,0,Detchd,1954.0,Unf,1.0
2081,50,RL,7200,NAmes,6,5,1954,1278,854,424,1278,1,0,Attchd,1954.0,Unf,1.0
2082,90,RL,8513,NAmes,5,5,1961,1800,1800,0,1800,2,0,,,,0.0
2083,50,RL,7200,NAmes,5,6,1955,1588,1024,564,1588,1,1,Detchd,1955.0,Unf,2.0
2084,20,RL,7200,NAmes,5,7,1954,825,825,0,825,1,0,Attchd,1954.0,Unf,1.0
2085,20,RL,7590,NAmes,5,5,1963,1117,1117,0,1117,1,0,Attchd,1963.0,Unf,1.0
2086,20,RM,9836,OldTown,6,5,2008,1133,1133,0,1133,1,0,Detchd,2008.0,Unf,1.0
2087,50,RM,9184,OldTown,5,7,1948,1323,948,375,1323,1,0,Detchd,1948.0,Unf,2.0
2088,70,RM,4800,OldTown,5,5,1910,1360,680,680,1360,1,0,Attchd,1910.0,Unf,1.0
2089,30,RM,4800,OldTown,5,4,1940,672,672,0,672,1,0,Detchd,1950.0,Unf,1.0
2090,75,RM,6000,OldTown,6,7,1915,1456,728,728,1456,1,1,Detchd,1915.0,Unf,1.0
2091,190,RM,11426,OldTown,4,6,1910,1594,828,658,1594,2,0,,,,0.0
2092,50,RM,7628,OldTown,4,6,1940,1656,1095,561,1656,2,0,Detchd,1958.0,Unf,2.0
2093,50,RM,7308,OldTown,5,5,1920,1740,960,780,1740,1,0,Detchd,1920.0,Unf,1.0
2094,30,RM,5400,OldTown,7,6,1920,1027,1027,0,1027,1,0,,,,0.0
2095,190,RM,10800,OldTown,6,6,1940,1436,884,552,1436,2,0,Detchd,1940.0,Unf,2.0
2096,30,RM,6756,OldTown,5,6,1910,899,899,0,899,1,0,Detchd,1930.0,Unf,1.0
2097,50,RM,5914,OldTown,5,9,1890,1080,684,396,1080,1,0,,,,0.0
2098,50,RM,9000,OldTown,5,6,1946,1499,904,595,1499,1,0,Detchd,1959.0,Unf,3.0
2099,20,RM,7311,OldTown,2,5,1946,407,407,0,407,1,0,Detchd,1949.0,Unf,1.0
2100,20,RM,12205,OldTown,3,1,1949,1588,1588,0,1588,2,0,,,,0.0
2101,190,RM,9142,OldTown,5,5,1900,1627,830,797,1627,2,0,Detchd,1950.0,Unf,2.0
2102,75,RM,5350,OldTown,7,8,1920,1450,730,720,1450,1,0,Detchd,1935.0,Unf,1.0
2103,50,RM,9143,OldTown,5,7,1900,1017,709,308,1017,1,0,Detchd,1961.0,Unf,1.0
2104,190,RM,9600,OldTown,5,5,1920,2350,1377,973,2350,2,0,2Types,1930.0,Unf,2.0
2105,70,RM,6000,OldTown,5,9,1905,1540,884,656,1540,1,1,,,,0.0
2106,70,RM,11340,OldTown,2,1,1920,1086,723,363,1086,1,0,Detchd,1920.0,Unf,2.0
2107,70,RM,10800,OldTown,7,7,1890,2495,1313,1182,2495,2,0,Detchd,1950.0,Unf,2.0
2108,20,RM,9750,OldTown,5,6,1959,984,984,0,984,1,0,Detchd,1959.0,Unf,1.0
2109,20,RM,8516,OldTown,4,6,1958,1093,1093,0,1093,1,0,Detchd,1959.0,Unf,1.0
2110,30,RL,7111,BrkSide,5,7,1928,1143,1143,0,1143,1,0,Detchd,1992.0,Unf,1.0
2111,50,RM,7425,BrkSide,7,7,1945,1668,1195,473,1668,1,1,Attchd,1945.0,Unf,1.0
2112,50,RL,7010,BrkSide,5,5,1935,1738,1144,594,1738,2,0,Detchd,1950.0,Unf,1.0
2113,50,RM,5000,BrkSide,5,7,1941,1210,832,378,1210,1,0,Detchd,1941.0,Unf,1.0
2114,70,RM,5870,BrkSide,6,9,1900,1290,736,554,1290,1,1,Detchd,1926.0,Unf,1.0
2115,50,RM,6000,BrkSide,6,7,1940,1672,1014,658,1672,1,1,Detchd,1940.0,Unf,1.0
2116,30,RM,6000,BrkSide,5,7,1924,949,949,0,949,1,0,Detchd,1924.0,Unf,2.0
2117,50,RM,6000,BrkSide,6,7,1937,1497,825,672,1497,2,0,Detchd,2004.0,Unf,1.0
2118,50,RM,6000,BrkSide,6,5,1939,1342,874,468,1342,2,0,Detchd,1939.0,Unf,1.0
2119,45,RM,5000,BrkSide,6,7,1926,1013,1013,0,1013,1,0,Detchd,1926.0,Unf,1.0
2120,50,RM,5520,BrkSide,5,7,1920,1216,565,651,1216,1,0,BuiltIn,1920.0,RFn,1.0
2121,20,RM,5940,BrkSide,4,7,1946,896,896,0,896,1,0,Detchd,1946.0,Unf,1.0
2122,50,RM,6240,BrkSide,4,7,1929,1136,624,512,1136,1,0,Detchd,1990.0,Unf,1.0
2123,30,RM,6120,BrkSide,5,6,1945,808,808,0,808,1,0,Attchd,1925.0,Unf,1.0
2124,50,RM,6240,BrkSide,7,5,1939,2009,1245,764,2009,2,0,Detchd,1939.0,Unf,2.0
2125,70,RM,6120,OldTown,5,5,1923,1902,1226,676,1902,2,0,Detchd,1960.0,Unf,2.0
2126,50,RL,9144,BrkSide,6,4,1915,1716,1170,546,1716,2,0,Detchd,1970.0,Unf,2.0
2127,60,RM,8094,OldTown,6,8,1910,1984,1242,742,1984,2,0,Detchd,,,1.0
2128,50,RM,4347,OldTown,6,8,1910,1609,825,784,1609,1,0,Detchd,1910.0,Unf,1.0
2129,30,RM,6291,IDOTRR,6,6,1930,768,768,0,768,1,0,Detchd,1930.0,Unf,2.0
2130,70,RM,10266,IDOTRR,6,6,1952,1536,768,768,1536,1,1,Detchd,1952.0,Unf,1.0
2131,50,RM,6876,IDOTRR,6,6,1938,1969,1272,0,1969,2,0,Detchd,1938.0,Unf,2.0
2132,50,RM,10320,IDOTRR,5,6,1915,1308,880,428,1308,2,0,Detchd,1950.0,Unf,2.0
2133,30,RM,7200,IDOTRR,6,7,1925,1040,1040,0,1040,1,0,Detchd,1993.0,Unf,2.0
2134,50,RM,7006,IDOTRR,6,6,1925,1236,788,448,1236,2,0,Detchd,1985.0,Unf,1.0
2135,30,RM,10320,IDOTRR,5,8,1912,759,759,0,759,1,0,Detchd,1997.0,Unf,2.0
2136,190,RM,10320,IDOTRR,3,3,1915,1344,808,536,1344,2,0,,,,0.0
2137,20,RL,9488,Sawyer,5,6,1947,1054,1054,0,1054,1,0,Detchd,1947.0,Unf,1.0
2138,85,RL,11235,Sawyer,5,6,1963,1075,1075,0,1075,1,0,Detchd,1996.0,Unf,2.0
2139,80,RL,13014,Sawyer,6,5,1978,1096,1096,0,1096,1,0,Attchd,1978.0,Unf,2.0
2140,20,RL,10265,Sawyer,5,7,1967,992,992,0,992,1,0,Attchd,1967.0,RFn,1.0
2141,85,RL,7703,Sawyer,6,8,1978,1034,1034,0,1034,1,0,Basment,1978.0,Fin,2.0
2142,20,RL,9981,Sawyer,5,5,1967,1073,1073,0,1073,1,0,Attchd,1967.0,RFn,1.0
2143,85,RL,7400,Sawyer,5,5,1984,1126,1126,0,1126,1,0,Attchd,1984.0,Unf,2.0
2144,190,RL,12900,Sawyer,5,4,1920,1140,1140,0,1140,1,0,CarPort,1920.0,Unf,2.0
2145,20,RL,9239,Sawyer,5,8,1963,960,960,0,960,1,0,Attchd,1963.0,Fin,1.0
2146,20,RL,14175,Sawyer,6,8,1956,1188,1188,0,1188,1,0,Attchd,1956.0,Unf,2.0
2147,190,RL,10532,ClearCr,5,3,1960,1721,1721,0,1721,2,0,Basment,1960.0,Unf,2.0
2148,50,RL,8375,Sawyer,5,7,1941,1350,864,486,1350,1,1,2Types,1973.0,Unf,3.0
2149,80,RL,10200,Sawyer,5,8,1970,904,904,0,904,1,0,2Types,1979.0,Unf,3.0
2150,20,RL,20270,ClearCr,7,6,1979,1524,1524,0,1524,2,0,Attchd,1979.0,Fin,2.0
2151,50,RL,5190,Edwards,7,5,1948,1079,617,462,1079,1,0,Attchd,1948.0,Unf,1.0
2152,30,RL,19550,Edwards,5,7,1940,1518,1518,0,1518,1,0,,,,0.0
2153,20,RL,9571,Edwards,5,6,1956,1509,1509,0,1509,1,0,Attchd,1956.0,Unf,1.0
2154,90,RL,9350,Edwards,5,5,1975,864,864,0,864,1,0,,,,0.0
2155,60,RL,9360,Edwards,6,8,1962,1269,621,648,1269,1,1,Detchd,1962.0,Unf,1.0
2156,60,RL,9771,SawyerW,6,5,1995,2814,1093,1721,2814,2,1,BuiltIn,1995.0,Fin,2.0
2157,20,RL,9938,SawyerW,7,5,1994,1626,1626,0,1626,2,1,Attchd,1994.0,RFn,2.0
2158,60,RL,14171,SawyerW,7,5,1993,2200,1101,1099,2200,2,1,Attchd,1993.0,RFn,2.0
2159,80,RL,10541,SawyerW,7,5,1996,2037,1302,735,2037,2,1,Attchd,1996.0,Fin,2.0
2160,60,RL,10616,CollgCr,7,5,2007,1356,628,728,1356,2,1,BuiltIn,2007.0,Fin,2.0
2161,20,RL,9345,CollgCr,8,5,2007,1615,1615,0,1615,2,0,Attchd,2007.0,RFn,3.0
2162,20,RL,11778,CollgCr,9,5,2008,2276,2276,0,2276,2,0,Attchd,2008.0,RFn,3.0
2163,20,RL,11778,CollgCr,9,5,2008,1766,1766,0,1766,2,1,Attchd,2008.0,Fin,3.0
2164,80,RL,11454,SawyerW,8,5,1995,1511,1511,0,1511,2,0,Attchd,1995.0,Fin,3.0
2165,20,RL,11500,ClearCr,6,6,1966,1643,1643,0,1643,2,0,Attchd,1966.0,Unf,2.0
2166,20,RL,9750,CollgCr,5,7,1994,990,990,0,990,1,0,Detchd,1997.0,Unf,2.0
2167,20,RL,8696,CollgCr,7,5,1997,1418,1418,0,1418,2,0,Attchd,1997.0,RFn,2.0
2168,60,RL,13142,CollgCr,6,5,1997,1771,872,899,1771,2,1,Attchd,1997.0,RFn,2.0
2169,60,RL,8998,CollgCr,7,5,2000,1652,782,870,1652,2,1,Attchd,2000.0,RFn,2.0
2170,60,RL,12192,CollgCr,7,5,2000,1823,928,895,1823,2,1,Attchd,2000.0,RFn,2.0
2171,20,RL,12250,CollgCr,5,6,1978,1174,1174,0,1174,1,0,Attchd,1978.0,Unf,2.0
2172,20,RL,9216,CollgCr,5,6,1975,1076,1076,0,1076,1,1,Detchd,1985.0,Unf,2.0
2173,20,RL,14330,CollgCr,5,6,1975,1558,1558,0,1558,2,0,Attchd,1975.0,Fin,2.0
2174,60,RL,10400,CollgCr,7,5,2001,2161,1290,871,2161,2,1,Attchd,2001.0,RFn,2.0
2175,60,RL,9720,CollgCr,9,5,2001,1947,1366,581,1947,2,1,BuiltIn,2001.0,Fin,3.0
2176,20,RL,14860,CollgCr,8,5,2002,1786,1786,0,1786,2,0,Attchd,2002.0,RFn,3.0
2177,60,RL,10905,CollgCr,7,5,2003,2327,1129,1198,2327,2,1,BuiltIn,2003.0,RFn,2.0
2178,60,RL,11690,CollgCr,8,5,1999,1764,886,878,1764,2,1,Attchd,1999.0,Unf,2.0
2179,120,RM,4426,CollgCr,6,5,2004,848,848,0,848,1,0,Attchd,2004.0,RFn,2.0
2180,90,RM,10126,CollgCr,6,5,1997,1838,1838,0,1838,2,0,Attchd,1998.0,Unf,3.0
2181,20,RL,9750,CollgCr,7,5,2004,1445,1445,0,1445,2,0,Attchd,2004.0,Unf,2.0
2182,20,RL,11058,CollgCr,7,6,2007,1564,1564,0,1564,2,0,Attchd,2007.0,RFn,3.0
2183,20,RL,9627,CollgCr,7,5,2007,1361,1361,0,1361,2,0,Attchd,2007.0,RFn,2.0
2184,20,RL,9825,Edwards,5,5,1966,1092,1092,0,1092,1,0,Attchd,1966.0,Unf,1.0
2185,85,RL,12102,Edwards,5,5,1976,1033,1033,0,1033,1,0,BuiltIn,1976.0,RFn,2.0
2186,20,RL,6500,Edwards,6,6,1976,1127,1127,0,1127,1,1,Detchd,1991.0,Unf,2.0
2187,80,RL,9638,Edwards,6,6,1977,1117,1117,0,1117,1,0,Attchd,1977.0,RFn,2.0
2188,60,RL,7200,Edwards,6,7,1976,1398,684,714,1398,1,1,Attchd,1976.0,Fin,2.0
2189,20,RL,47007,Edwards,5,7,1959,3820,3820,0,3820,3,1,Attchd,1959.0,Unf,2.0
2190,90,RL,6012,Edwards,4,5,1955,1152,1152,0,1152,2,0,,,,0.0
2191,90,RL,6845,Edwards,4,5,1955,1152,1152,0,1152,2,0,,,,0.0
2192,190,RL,6931,Edwards,4,5,1955,784,784,0,784,1,0,,,,0.0
2193,50,RL,12180,Edwards,5,7,1938,1053,585,468,1053,1,1,,,,0.0
2194,50,RL,8050,Edwards,5,8,1947,1137,929,208,1137,1,1,,,,0.0
2195,20,RL,9520,Edwards,4,5,1953,930,930,0,930,1,0,Attchd,1953.0,RFn,1.0
2196,80,RL,7692,Edwards,4,6,1954,1204,1204,0,1204,1,0,Basment,1954.0,Unf,1.0
2197,30,RL,5142,Edwards,4,7,1923,1292,949,343,1292,1,1,Detchd,1923.0,Unf,1.0
2198,30,RL,7290,SWISU,7,8,1921,1424,1424,0,1424,2,0,Attchd,1921.0,Unf,1.0
2199,90,RL,7804,SWISU,6,7,1930,1920,960,960,1920,2,2,Detchd,1930.0,Unf,2.0
2200,70,RL,8969,Crawfor,6,6,1926,1316,672,644,1316,1,0,Detchd,2001.0,Unf,1.0
2201,50,RL,15564,Crawfor,6,6,1914,1264,676,588,1264,1,0,Detchd,1994.0,Unf,2.0
2202,70,RL,7609,Crawfor,8,9,1925,1512,798,714,1512,2,0,Detchd,1925.0,Unf,1.0
2203,70,RL,9650,Crawfor,6,3,1923,1603,819,784,1603,1,0,Attchd,1980.0,Unf,2.0
2204,50,RL,11700,Crawfor,5,6,1937,1938,1265,673,1938,2,0,Detchd,1937.0,Unf,1.0
2205,50,RL,9260,Crawfor,5,4,1938,1374,932,442,1374,1,0,Detchd,1938.0,Unf,1.0
2206,20,RL,7801,Crawfor,6,5,1951,1091,1091,0,1091,1,0,Attchd,1951.0,Fin,1.0
2207,70,RL,9670,Crawfor,8,6,1935,1873,983,890,1873,1,1,Detchd,1935.0,Fin,2.0
2208,50,RL,12392,Crawfor,7,9,1950,2161,1218,943,2161,2,1,Attchd,1994.0,Fin,2.0
2209,20,RL,26073,Crawfor,5,5,1956,1898,1898,0,1898,2,1,Attchd,1956.0,Unf,2.0
2210,160,RM,1879,Blueste,6,6,1980,1032,516,516,1032,1,0,Detchd,1980.0,Unf,2.0
2211,30,RM,7000,IDOTRR,6,8,1926,919,919,0,919,1,0,Detchd,1926.0,Unf,1.0
2212,50,RM,6000,IDOTRR,6,8,1940,1090,760,330,1090,1,0,Detchd,1940.0,Unf,1.0
2213,50,RM,8155,IDOTRR,5,7,1930,1200,780,420,1200,1,0,,,,0.0
2214,80,RM,6000,IDOTRR,5,5,1967,1656,1092,564,1656,1,1,Attchd,1967.0,Unf,1.0
2215,30,RM,7392,IDOTRR,5,7,1930,912,912,0,912,1,0,Detchd,1934.0,RFn,1.0
2216,50,RM,9000,IDOTRR,5,5,1958,1955,1151,804,1955,2,0,Attchd,1958.0,Fin,1.0
2217,20,,14584,IDOTRR,1,5,1952,733,733,0,733,1,0,Attchd,1952.0,Unf,2.0
2218,70,C (all),5280,IDOTRR,4,7,1895,1361,825,536,1361,1,0,Detchd,1895.0,Unf,1.0
2219,50,C (all),5150,IDOTRR,4,7,1910,1049,671,378,1049,1,0,Detchd,1910.0,Unf,1.0
2220,70,C (all),9000,IDOTRR,4,6,1920,864,432,432,864,1,1,Detchd,1920.0,Unf,1.0
2221,120,RM,3843,Crawfor,8,5,2007,1648,1648,0,1648,2,0,Attchd,2007.0,Fin,2.0
2222,120,RM,3811,Crawfor,7,5,2004,1646,1646,0,1646,2,0,Attchd,2004.0,Fin,2.0
2223,20,RL,23730,Mitchel,7,5,1996,2032,2032,0,2032,3,0,Attchd,1996.0,Fin,3.0
2224,60,RL,11050,Mitchel,7,5,1996,1820,910,910,1820,2,1,Attchd,1996.0,Unf,3.0
2225,90,RL,10260,Mitchel,5,4,1976,1872,936,936,1872,2,2,Attchd,1976.0,Unf,2.0
2226,20,RL,9990,Mitchel,4,5,1991,1689,1689,0,1689,2,0,Attchd,1991.0,Unf,2.0
2227,120,RL,4084,Timber,7,6,1986,1501,1501,0,1501,2,0,Attchd,1986.0,Fin,2.0
2228,20,RL,11563,Timber,8,5,2006,1537,1537,0,1537,2,0,Attchd,2007.0,Fin,3.0
2229,60,RL,12852,Timber,8,5,2007,1780,920,860,1780,2,1,Attchd,2007.0,Fin,2.0
2230,80,RL,9802,Timber,5,5,2006,1442,712,730,1442,2,1,BuiltIn,2007.0,Fin,2.0
2231,60,RL,12018,Timber,7,5,2008,1612,796,816,1612,2,1,Attchd,2008.0,Fin,3.0
2232,20,RL,12890,Timber,6,5,1989,1495,1495,0,1495,2,0,Attchd,1989.0,Unf,2.0
2233,20,RL,18265,Timber,6,5,1986,1256,1256,0,1256,2,0,Attchd,1986.0,Unf,2.0
2234,20,RL,11202,Timber,8,5,2003,1440,1440,0,1440,2,0,Attchd,2003.0,Fin,2.0
2235,20,RL,7915,Timber,6,5,1999,1675,1675,0,1675,2,0,Attchd,1999.0,RFn,2.0
2236,20,RL,11449,Timber,8,5,2007,1728,1728,0,1728,2,0,Attchd,2007.0,Fin,2.0
2237,20,RL,11447,Timber,8,5,2005,1964,1964,0,1964,2,1,Attchd,2005.0,Fin,3.0
2238,90,RM,8940,Mitchel,7,5,1997,1344,1344,0,1344,2,0,Attchd,1997.0,Fin,4.0
2239,20,RL,9278,Mitchel,5,5,2007,1092,1092,0,1092,1,0,,,,0.0
2240,120,RM,4500,Mitchel,6,5,1997,1189,1189,0,1189,2,0,Attchd,1997.0,RFn,2.0
2241,85,RL,14137,Mitchel,4,5,1964,1200,1200,0,1200,1,0,2Types,1964.0,Fin,3.0
2242,120,RM,4224,MeadowV,5,6,1975,1040,1040,0,1040,1,0,Attchd,1975.0,Unf,2.0
2243,160,RM,2665,MeadowV,5,7,1976,1475,925,550,1475,2,0,Attchd,1976.0,Unf,1.0
2244,180,RM,1974,MeadowV,4,7,1973,988,526,462,988,1,0,BuiltIn,1973.0,RFn,1.0
2245,180,RM,1596,MeadowV,4,6,1973,988,526,462,988,1,0,BuiltIn,1973.0,RFn,1.0
2246,20,RL,17979,Mitchel,5,6,1968,1160,1160,0,1160,1,0,Attchd,1968.0,Unf,1.0
2247,160,RM,1477,MeadowV,6,9,1970,1092,546,546,1092,2,1,,,,0.0
2248,20,RL,6490,Mitchel,5,7,1983,816,816,0,816,1,0,Attchd,1983.0,Unf,1.0
2249,20,RL,6600,Mitchel,5,6,1982,845,845,0,845,1,0,Attchd,1982.0,Unf,1.0
2250,20,RL,12395,Mitchel,5,6,1984,889,889,0,889,1,0,Attchd,1984.0,Unf,2.0
2251,70,,56600,IDOTRR,5,1,1900,1836,1150,686,1836,2,0,Detchd,1900.0,Unf,1.0
2252,20,RL,10667,NAmes,6,6,1971,1587,1587,0,1587,2,0,Attchd,1971.0,Unf,2.0
2253,80,RL,8872,Gilbert,6,5,1997,1384,754,630,1384,2,1,BuiltIn,1997.0,Fin,2.0
2254,80,RL,10147,Gilbert,6,5,1994,1694,924,770,1694,2,1,BuiltIn,1994.0,Fin,2.0
2255,60,RL,8637,Gilbert,6,5,1999,1714,947,767,1714,2,1,Attchd,2000.0,Fin,2.0
2256,60,RL,7875,Gilbert,7,5,1996,1553,691,862,1553,2,1,Attchd,1996.0,Fin,2.0
2257,60,RL,7500,Gilbert,6,5,1999,2299,957,1342,2299,3,1,Attchd,1999.0,Fin,2.0
2258,20,RL,9556,Gilbert,7,5,1992,1187,1187,0,1187,2,0,Attchd,1992.0,RFn,2.0
2259,60,RL,7655,Gilbert,6,5,1993,1642,910,732,1642,2,1,Attchd,1993.0,RFn,2.0
2260,20,RL,18160,Gilbert,6,6,1964,1128,1128,0,1128,1,0,Attchd,1964.0,Unf,2.0
2261,120,RL,4740,StoneBr,8,5,1988,1179,1179,0,1179,2,0,Attchd,1988.0,RFn,2.0
2262,120,RL,5118,StoneBr,8,5,1990,1321,1321,0,1321,1,0,Attchd,1990.0,RFn,2.0
2263,60,RL,12328,StoneBr,8,5,2005,2541,1164,1377,2541,3,1,BuiltIn,2005.0,Fin,3.0
2264,20,RL,51974,StoneBr,9,5,2006,2338,2338,0,2338,2,1,Attchd,2005.0,Fin,3.0
2265,190,RL,41600,Gilbert,5,5,1969,1424,1424,0,1424,1,1,2Types,1969.0,Unf,3.0
2266,120,RL,8035,StoneBr,9,5,2006,1612,1612,0,1612,2,0,Attchd,2006.0,Fin,2.0
2267,20,RL,14082,StoneBr,8,5,2006,2234,2234,0,2234,1,1,Attchd,2006.0,RFn,2.0
2268,20,RL,13870,StoneBr,10,5,2006,2042,2042,0,2042,2,0,Attchd,2007.0,Fin,3.0
2269,20,RL,10960,NWAmes,6,5,1984,1284,1284,0,1284,2,0,Attchd,1984.0,Unf,2.0
2270,60,RL,12090,NWAmes,7,7,1981,1479,725,754,1479,2,1,Attchd,1981.0,RFn,2.0
2271,20,RL,12299,NWAmes,7,6,1978,1664,1664,0,1664,2,0,Attchd,1978.0,Fin,2.0
2272,60,RL,11339,NWAmes,7,5,1979,1930,1085,845,1930,2,1,Attchd,1979.0,Fin,2.0
2273,20,RL,11850,NWAmes,6,6,1984,1177,1177,0,1177,2,0,Attchd,1984.0,Fin,2.0
2274,20,RL,10400,NWAmes,6,5,1979,1353,1353,0,1353,2,0,Attchd,1979.0,RFn,2.0
2275,20,RL,13001,NWAmes,6,5,1971,1220,1220,0,1220,2,0,Attchd,1971.0,Unf,2.0
2276,80,RL,8991,NWAmes,7,6,1976,1324,1324,0,1324,2,0,Attchd,1976.0,Fin,2.0
2277,60,RL,8000,NWAmes,6,6,1974,1877,1084,793,1877,2,1,Attchd,1974.0,Unf,2.0
2278,20,RL,9457,NAmes,5,6,1970,1422,1422,0,1422,1,0,Detchd,1988.0,Unf,2.0
2279,20,RL,7920,NAmes,5,5,1970,914,914,0,914,1,0,Attchd,1970.0,RFn,1.0
2280,20,RL,17199,NAmes,4,7,1961,914,914,0,914,1,0,Basment,1961.0,Unf,1.0
2281,120,RH,4113,NAmes,6,5,2001,1337,1337,0,1337,2,0,Attchd,2001.0,Fin,2.0
2282,120,RH,10943,NAmes,6,5,1997,1337,1337,0,1337,2,0,Attchd,1997.0,Fin,2.0
2283,160,RM,2205,BrDale,6,6,1973,1092,525,567,1092,1,1,Detchd,1973.0,Unf,1.0
2284,160,RM,2058,BrDale,6,5,1973,1218,672,546,1218,1,1,Detchd,1973.0,Unf,1.0
2285,120,RL,2304,NPkVill,7,7,1978,1055,1055,0,1055,2,0,Attchd,1978.0,Unf,1.0
2286,20,RL,7150,NAmes,5,6,1966,988,988,0,988,1,0,Detchd,1974.0,Unf,1.0
2287,20,RL,12469,NridgHt,9,5,2006,1816,1816,0,1816,2,0,Attchd,2007.0,Fin,3.0
2288,20,RL,11825,NridgHt,8,5,2006,1694,1694,0,1694,2,0,Attchd,2006.0,RFn,3.0
2289,20,RL,14333,NridgHt,8,5,2007,2122,2122,0,2122,2,1,Attchd,2007.0,Fin,3.0
2290,60,RL,13641,NridgHt,9,5,2007,2656,1943,713,2656,2,1,Attchd,2007.0,RFn,3.0
2291,60,RL,13440,NridgHt,8,5,2006,2550,1148,1402,2550,2,1,BuiltIn,2006.0,Fin,3.0
2292,20,RL,15431,NridgHt,10,5,2005,2046,2046,0,2046,2,1,Attchd,2005.0,Fin,3.0
2293,20,RL,13891,NridgHt,9,5,2007,2552,2552,0,2552,2,0,Attchd,2007.0,Fin,3.0
2294,60,RL,13654,NridgHt,9,5,2005,2758,1722,1036,2758,2,1,BuiltIn,2005.0,Fin,3.0
2295,20,RL,17169,NridgHt,10,5,2007,2290,2290,0,2290,2,1,Attchd,2007.0,Fin,3.0
2296,60,RL,16659,NridgHt,8,5,2007,2152,1582,570,2152,2,1,Detchd,2007.0,Unf,2.0
2297,60,RL,9709,NridgHt,8,5,2007,2100,958,1142,2100,2,1,BuiltIn,2007.0,Fin,3.0
2298,20,RL,13615,NridgHt,9,5,2006,1802,1802,0,1802,2,1,Attchd,2006.0,Fin,3.0
2299,60,RL,13069,NridgHt,8,5,2004,2956,1718,1238,2956,2,1,BuiltIn,2004.0,RFn,3.0
2300,60,RL,14277,NridgHt,8,5,2003,2385,1217,1168,2385,2,1,Attchd,2003.0,Fin,3.0
2301,60,RL,12568,NridgHt,8,5,2007,1818,895,923,1818,2,1,Attchd,2007.0,Fin,3.0
2302,20,RL,9926,NridgHt,7,5,2005,1614,1614,0,1614,2,0,Attchd,2005.0,RFn,3.0
2303,20,RL,9254,NridgHt,8,5,2005,1721,1721,0,1721,2,0,Attchd,2005.0,RFn,2.0
2304,60,RL,10732,NridgHt,8,5,2006,1828,1298,530,1828,2,1,BuiltIn,2006.0,RFn,3.0
2305,120,RL,3901,NridgHt,6,5,2005,1302,1302,0,1302,1,1,Attchd,2005.0,RFn,2.0
2306,120,RL,3903,NridgHt,6,5,2005,1302,1302,0,1302,1,1,Attchd,2005.0,RFn,2.0
2307,120,RL,6289,NridgHt,6,5,2005,1362,1362,0,1362,2,0,Attchd,2005.0,RFn,2.0
2308,120,RL,4590,NridgHt,8,5,2006,1554,1554,0,1554,2,0,Attchd,2006.0,RFn,2.0
2309,120,RL,7841,NridgHt,9,5,2005,1577,1577,0,1577,2,0,Attchd,2005.0,RFn,2.0
2310,120,RL,6240,NridgHt,8,5,2006,1324,1324,0,1324,2,0,Attchd,2006.0,Fin,2.0
2311,120,RL,3242,NridgHt,7,5,2003,1405,1405,0,1405,2,0,Attchd,2003.0,RFn,2.0
2312,60,RL,15810,Gilbert,6,5,2007,1496,768,728,1496,3,0,Attchd,2007.0,Unf,2.0
2313,60,RL,10237,Gilbert,6,5,2005,1536,768,768,1536,2,1,Attchd,2005.0,Fin,2.0
2314,60,RL,13204,Gilbert,7,5,2006,1458,608,850,1458,2,0,BuiltIn,2007.0,Fin,2.0
2315,60,RL,8857,Gilbert,6,5,2006,1495,738,757,1495,2,1,Attchd,2006.0,RFn,2.0
2316,60,RL,9729,Gilbert,6,5,2006,1746,698,1048,1746,2,1,BuiltIn,2007.0,Unf,3.0
2317,20,RL,12216,Gilbert,6,5,2005,1326,1326,0,1326,2,0,Attchd,2005.0,Fin,2.0
2318,60,RL,8229,Gilbert,6,5,2007,1504,752,752,1504,2,1,Attchd,2007.0,Fin,2.0
2319,60,RL,7713,Gilbert,7,5,2007,1456,728,728,1456,2,1,Attchd,2007.0,Fin,2.0
2320,20,RL,7697,Gilbert,7,6,2007,1258,1258,0,1258,2,0,Attchd,2007.0,RFn,2.0
2321,120,RL,3621,Blmngtn,8,5,2003,1589,1589,0,1589,2,0,Attchd,2003.0,Fin,3.0
2322,20,RL,3710,Blmngtn,7,5,2007,1266,1266,0,1266,2,0,Attchd,2007.0,Fin,2.0
2323,80,RL,16219,Gilbert,7,5,2004,1119,1119,0,1119,2,0,Attchd,2004.0,Fin,2.0
2324,80,RL,11084,Gilbert,7,5,2004,1374,744,630,1374,2,1,BuiltIn,2004.0,Fin,2.0
2325,20,RL,10936,Gilbert,7,5,2006,1525,1525,0,1525,2,1,Attchd,2006.0,RFn,2.0
2326,80,RL,11950,Gilbert,7,5,2003,1394,754,640,1394,2,1,BuiltIn,2003.0,Fin,2.0
2327,60,RL,7875,Gilbert,7,5,2003,1948,847,1101,1948,2,1,BuiltIn,2003.0,Fin,2.0
2328,60,RL,8740,Gilbert,7,5,2002,1995,864,1131,1995,2,1,BuiltIn,2002.0,Fin,2.0
2329,60,RL,9487,Gilbert,6,5,2000,1690,940,750,1690,2,1,Attchd,2000.0,RFn,2.0
2330,60,RL,9649,Gilbert,6,5,1999,1644,961,683,1644,2,1,Attchd,1999.0,RFn,2.0
2331,60,RL,12191,NoRidge,8,5,1997,2551,1779,772,2551,2,1,Attchd,1998.0,Fin,3.0
2332,60,RL,10557,NoRidge,9,5,1998,3078,1671,1407,3078,2,1,Attchd,1998.0,Fin,3.0
2333,60,RL,11002,NoRidge,8,5,1998,2582,1411,1171,2582,2,1,Attchd,1998.0,Fin,3.0
2334,60,RL,10790,NoRidge,7,5,1998,2385,1108,1277,2385,2,1,BuiltIn,1998.0,Fin,3.0
2335,60,RL,11762,NoRidge,8,5,1992,2202,1105,1097,2202,2,1,Attchd,1992.0,RFn,2.0
2336,60,RL,9044,NoRidge,8,5,1996,2538,1335,1203,2538,2,1,Attchd,1996.0,RFn,3.0
2337,20,RL,9910,Somerst,7,6,2007,1369,1369,0,1369,2,0,Attchd,2007.0,Unf,2.0
2338,20,RL,11830,Somerst,8,5,2007,1542,1542,0,1542,2,0,Attchd,2007.0,Unf,3.0
2339,20,RL,10612,Somerst,8,5,2006,1534,1534,0,1534,2,0,Attchd,2006.0,Fin,2.0
2340,20,RL,12291,Somerst,10,5,2007,1966,1966,0,1966,2,0,Attchd,2007.0,Fin,3.0
2341,20,RL,9965,Somerst,7,5,2007,1528,1528,0,1528,3,2,Attchd,2007.0,Unf,2.0
2342,20,RL,8847,Somerst,8,5,2005,1538,1538,0,1538,2,0,Attchd,2005.0,RFn,2.0
2343,20,RL,8251,Somerst,7,5,2005,1506,1506,0,1506,2,0,Attchd,2005.0,RFn,2.0
2344,60,RL,9605,Somerst,7,5,2006,1977,982,995,1977,2,1,Attchd,2006.0,RFn,3.0
2345,60,RL,8778,Somerst,8,5,2006,1830,1302,528,1830,2,1,BuiltIn,2006.0,RFn,3.0
2346,20,FV,8640,Somerst,8,5,2007,1338,1338,0,1338,2,0,Attchd,2007.0,RFn,2.0
2347,20,FV,9000,Somerst,7,5,2006,1335,1335,0,1335,2,0,Attchd,2007.0,RFn,2.0
2348,60,FV,8640,Somerst,8,5,2007,1792,896,896,1792,2,1,Attchd,2007.0,Fin,2.0
2349,60,FV,10411,Somerst,5,5,2007,1588,725,863,1588,3,0,Attchd,2007.0,Unf,2.0
2350,60,FV,12217,Somerst,8,5,2007,1880,955,925,1880,2,1,Attchd,2007.0,Fin,3.0
2351,20,FV,10440,Somerst,8,5,2007,1584,1584,0,1584,2,0,Attchd,2007.0,Fin,2.0
2352,20,FV,11824,Somerst,8,5,2006,1685,1685,0,1685,2,0,Attchd,2006.0,Fin,3.0
2353,60,FV,10625,Somerst,6,5,2004,2443,1158,1285,2443,2,1,BuiltIn,2004.0,RFn,3.0
2354,20,RL,7500,SawyerW,6,5,2006,1100,1100,0,1100,1,1,,,,0.0
2355,20,RL,7500,SawyerW,7,5,2006,1143,1143,0,1143,1,1,,,,0.0
2356,20,RL,12450,SawyerW,5,5,2003,1094,1094,0,1094,1,0,Detchd,2004.0,Unf,2.0
2357,20,RL,7441,SawyerW,7,5,2006,1486,1486,0,1486,2,0,Attchd,2006.0,RFn,2.0
2358,60,RL,11613,SawyerW,6,5,1993,1820,920,900,1820,2,1,Attchd,1993.0,RFn,2.0
2359,160,RL,8012,SawyerW,6,5,1980,1266,630,636,1266,1,1,Attchd,1980.0,RFn,1.0
2360,20,RL,6285,Sawyer,5,5,1977,894,894,0,894,1,0,Detchd,1979.0,Unf,1.0
2361,20,RL,7476,Sawyer,5,7,1968,1040,1040,0,1040,1,1,Detchd,1991.0,Fin,2.0
2362,60,RL,19522,Veenker,7,5,1990,2503,1271,1232,2503,2,1,Attchd,1990.0,RFn,2.0
2363,20,RL,10751,Sawyer,5,5,1974,1037,1037,0,1037,1,0,Attchd,1974.0,RFn,2.0
2364,20,RL,12712,Sawyer,6,7,1973,1055,1055,0,1055,1,0,Attchd,1973.0,RFn,2.0
2365,120,FV,4379,Somerst,8,5,2004,1378,1378,0,1378,2,0,Attchd,2004.0,Fin,2.0
2366,120,FV,3523,Somerst,8,5,2006,1151,1151,0,1151,2,0,Attchd,2006.0,Fin,2.0
2367,120,FV,3784,Somerst,8,5,2006,1565,1565,0,1565,2,0,Attchd,2006.0,Fin,2.0
2368,120,FV,3606,Somerst,7,5,2006,1352,1352,0,1352,2,0,Attchd,2006.0,RFn,2.0
2369,120,FV,5330,Somerst,8,5,2006,1550,1550,0,1550,2,1,Attchd,2007.0,Fin,2.0
2370,160,FV,2280,Somerst,6,5,1999,1501,757,744,1501,2,1,Detchd,1999.0,Unf,2.0
2371,160,FV,2117,Somerst,6,5,2000,1573,769,804,1573,2,1,Detchd,2000.0,Unf,2.0
2372,20,FV,7321,Somerst,7,5,1999,1358,1358,0,1358,2,0,Detchd,1999.0,Unf,2.0
2373,60,FV,8010,Somerst,8,5,2003,2048,1072,976,2048,2,1,Detchd,2003.0,Unf,2.0
2374,60,FV,8413,Somerst,8,5,1998,2362,1220,1142,2362,2,1,Attchd,1998.0,RFn,2.0
2375,120,RL,9466,Veenker,8,5,1994,1494,1494,0,1494,1,1,Attchd,1994.0,Fin,2.0
2376,20,RL,12000,Veenker,7,6,1980,2362,2362,0,2362,2,1,Attchd,1980.0,RFn,2.0
2377,20,RL,17778,Veenker,8,5,1981,2497,2497,0,2497,2,0,Attchd,1981.0,RFn,2.0
2378,20,RL,11700,NWAmes,6,6,1968,1152,1152,0,1152,1,1,Attchd,1968.0,RFn,2.0
2379,60,RL,8000,NWAmes,6,6,1970,2411,1403,1008,2411,2,1,Attchd,1970.0,RFn,2.0
2380,85,RL,8723,NWAmes,6,6,1969,1082,1082,0,1082,1,0,Attchd,1969.0,Unf,2.0
2381,20,RL,11700,NWAmes,6,5,1968,1295,1295,0,1295,1,1,Attchd,1968.0,Fin,2.0
2382,20,RL,11358,NWAmes,7,7,1972,1610,1610,0,1610,2,0,Attchd,1972.0,RFn,2.0
2383,20,RL,9547,NWAmes,7,6,1993,1594,1594,0,1594,2,0,Attchd,1993.0,RFn,2.0
2384,60,RL,10530,NWAmes,7,6,1993,2075,1091,984,2075,2,1,Attchd,1993.0,Unf,2.0
2385,20,RL,10738,NWAmes,6,7,1966,1093,1093,0,1093,2,0,Attchd,1966.0,RFn,2.0
2386,20,RL,10800,NWAmes,6,5,1963,1052,1052,0,1052,1,0,Attchd,1963.0,Fin,1.0
2387,20,RL,8050,NAmes,5,6,1967,1107,1107,0,1107,1,0,Attchd,1967.0,RFn,1.0
2388,90,RL,10899,NAmes,4,5,1964,1224,1224,0,1224,2,0,CarPort,1964.0,Unf,3.0
2389,20,RL,7450,NAmes,5,5,1956,1074,1074,0,1074,1,0,Detchd,1966.0,Unf,2.0
2390,20,RL,14357,NAmes,5,5,1961,1187,1187,0,1187,1,0,Attchd,1961.0,RFn,2.0
2391,20,RL,8243,NAmes,5,7,1961,964,964,0,964,1,0,Detchd,1985.0,Fin,2.0
2392,20,RL,8680,NAmes,5,7,1960,894,894,0,894,1,0,Detchd,1965.0,Unf,1.0
2393,20,RL,8800,NAmes,7,6,1966,1200,1200,0,1200,2,0,Attchd,1966.0,RFn,2.0
2394,80,RL,9200,NAmes,6,5,1965,1042,1042,0,1042,2,0,Attchd,1965.0,RFn,2.0
2395,60,RL,8800,NAmes,6,7,1964,2154,845,1309,2154,2,1,Attchd,1964.0,RFn,2.0
2396,20,RL,11382,NAmes,6,5,1964,1374,1374,0,1374,1,0,Attchd,1964.0,RFn,1.0
2397,20,RL,22002,NAmes,6,7,1959,1652,1652,0,1652,1,1,Attchd,1959.0,RFn,2.0
2398,45,RL,12172,NAmes,5,7,1940,908,908,0,908,1,0,Attchd,1975.0,Unf,2.0
2399,20,RL,5000,BrkSide,3,3,1946,666,666,0,666,1,0,,,,0.0
2400,50,RL,3500,BrkSide,3,5,1945,670,442,228,670,1,0,,,,0.0
2401,20,RL,5175,BrkSide,5,8,1958,808,808,0,808,1,0,Detchd,1963.0,Unf,1.0
2402,20,RL,9600,NAmes,5,6,1955,1150,1150,0,1150,1,0,Attchd,1955.0,Fin,1.0
2403,90,RL,8668,NAmes,5,5,1968,1560,1560,0,1560,2,0,Detchd,1968.0,Unf,3.0
2404,85,RL,10050,NAmes,5,6,1966,1280,1280,0,1280,2,0,Basment,1966.0,Fin,2.0
2405,80,RL,9600,NAmes,6,5,1961,1254,1254,0,1254,1,0,Attchd,1961.0,RFn,2.0
2406,20,RL,8760,NAmes,6,7,1957,936,936,0,936,1,0,Attchd,1957.0,RFn,1.0
2407,20,RL,6860,NAmes,5,6,1956,1008,1008,0,1008,1,0,Detchd,1964.0,Unf,1.0
2408,20,RL,8250,NAmes,5,7,1963,1053,1053,0,1053,1,0,2Types,1994.0,RFn,2.0
2409,20,RL,9100,NAmes,5,5,1960,1144,1144,0,1144,1,0,Attchd,1960.0,RFn,1.0
2410,20,RL,9736,NAmes,6,6,1957,1721,1721,0,1721,1,0,Attchd,1957.0,Unf,2.0
2411,20,RL,9770,NAmes,5,5,1957,922,922,0,922,1,0,Attchd,1957.0,Unf,1.0
2412,20,RL,12198,NAmes,5,6,1955,1411,1411,0,1411,1,0,Attchd,1955.0,RFn,1.0
2413,20,RL,10050,NAmes,5,5,1955,1216,1216,0,1216,1,0,Attchd,1955.0,RFn,1.0
2414,20,RL,11556,NAmes,5,9,1953,1154,1154,0,1154,1,1,Detchd,1962.0,Unf,1.0
2415,90,RL,8078,NAmes,5,5,1958,1560,1560,0,1560,2,0,Detchd,1958.0,Unf,2.0
2416,20,RL,10950,NAmes,6,6,1952,948,948,0,948,1,0,Detchd,1952.0,Unf,2.0
2417,20,RL,7942,NAmes,6,7,1953,1040,1040,0,1040,1,0,Attchd,1953.0,Fin,1.0
2418,20,RL,8540,NAmes,5,8,1956,925,925,0,925,1,0,Detchd,1956.0,Unf,1.0
2419,50,RL,7150,NAmes,4,4,1955,1540,1040,500,1540,1,0,Detchd,2002.0,Unf,1.0
2420,20,RL,8400,NAmes,5,5,1955,925,925,0,925,1,0,Attchd,1955.0,Unf,1.0
2421,20,RL,9532,NAmes,4,6,1953,1647,1647,0,1647,1,0,Attchd,1953.0,Fin,1.0
2422,20,RL,15783,OldTown,5,5,1952,924,924,0,924,1,0,Detchd,1952.0,Unf,1.0
2423,50,RL,14190,OldTown,4,7,1890,1544,1000,544,1544,2,0,,,,0.0
2424,50,RL,12099,NAmes,5,6,1953,1728,1216,0,1728,1,0,Attchd,1953.0,Unf,1.0
2425,70,RL,21281,NAmes,5,4,1935,3086,1308,1778,3086,3,1,BuiltIn,2007.0,Unf,3.0
2426,50,RL,10284,OldTown,4,7,1925,1281,845,436,1281,2,0,Detchd,1978.0,Unf,2.0
2427,70,RL,10800,OldTown,5,9,1895,1534,751,783,1534,1,1,,,,0.0
2428,80,RL,10090,NAmes,7,5,1963,1651,1035,616,1651,2,0,BuiltIn,1963.0,Unf,1.0
2429,20,RL,8700,NAmes,5,7,1961,888,888,0,888,1,0,Attchd,1961.0,Unf,1.0
2430,20,RL,8300,NAmes,6,6,1968,952,952,0,952,1,0,Attchd,1968.0,Unf,1.0
2431,20,RL,7200,NAmes,5,3,1950,1238,1238,0,1238,1,1,Attchd,1950.0,Unf,1.0
2432,20,RL,7500,NAmes,5,7,1959,1040,1040,0,1040,1,0,Attchd,1959.0,RFn,1.0
2433,20,RL,7315,NAmes,5,6,1958,1170,1170,0,1170,1,0,Attchd,1958.0,RFn,1.0
2434,20,RL,7903,NAmes,5,5,1960,1242,1242,0,1242,1,1,Attchd,1960.0,RFn,1.0
2435,20,RL,8000,NAmes,5,5,1960,1377,1377,0,1377,1,0,Attchd,1965.0,Unf,1.0
2436,20,RL,7000,NAmes,5,6,1961,925,925,0,925,1,0,Attchd,1961.0,Fin,1.0
2437,20,RL,6600,NAmes,5,5,1962,864,864,0,864,1,0,Detchd,1962.0,Unf,1.0
2438,85,RL,6760,NAmes,5,5,1962,936,936,0,936,1,0,Attchd,1962.0,RFn,1.0
2439,30,RM,6978,OldTown,5,7,1926,960,960,0,960,1,0,Detchd,1981.0,RFn,2.0
2440,50,RM,6000,OldTown,6,6,1927,1296,866,430,1296,1,0,Detchd,1980.0,Unf,2.0
2441,30,RM,4480,OldTown,5,5,1922,1022,1022,0,1022,1,0,Detchd,1922.0,Unf,1.0
2442,30,RM,3153,OldTown,5,6,1920,967,967,0,967,1,0,Detchd,1920.0,Unf,1.0
2443,30,RM,7200,OldTown,5,8,1940,1072,1072,0,1072,1,0,Detchd,1940.0,Unf,2.0
2444,50,RM,9000,OldTown,5,8,1900,1174,680,494,1174,1,0,Detchd,2000.0,Unf,2.0
2445,50,RM,5925,OldTown,4,6,1900,1141,761,380,1141,1,0,Detchd,1930.0,Unf,1.0
2446,70,RM,9639,OldTown,4,8,1900,1798,1156,642,1798,2,1,Detchd,1935.0,Unf,2.0
2447,70,RM,10337,OldTown,8,9,1910,1772,909,863,1772,2,1,Detchd,1992.0,Unf,2.0
2448,70,RM,9863,OldTown,6,6,1927,1642,914,728,1642,1,1,Detchd,1927.0,Unf,1.0
2449,70,RM,4571,OldTown,5,7,1910,1232,616,616,1232,1,0,Detchd,1920.0,Unf,2.0
2450,50,RM,8398,OldTown,6,8,1910,1650,991,659,1650,2,0,Detchd,1979.0,Unf,2.0
2451,70,RM,3600,OldTown,5,7,1930,1358,687,671,1358,1,1,Detchd,2004.0,Unf,1.0
2452,75,RM,13500,OldTown,7,8,1879,2454,1312,1142,2454,2,0,Attchd,1950.0,Unf,2.0
2453,20,RM,8626,OldTown,4,6,1956,968,968,0,968,1,0,Attchd,1956.0,Unf,1.0
2454,80,RM,11800,OldTown,4,7,1949,1382,1382,0,1382,2,0,Attchd,1957.0,RFn,1.0
2455,40,RL,6854,BrkSide,5,7,1925,1060,916,144,1060,1,0,Detchd,1969.0,Unf,1.0
2456,50,RM,8674,BrkSide,5,6,1950,1435,910,525,1435,1,0,Detchd,1950.0,Unf,1.0
2457,50,RM,6125,BrkSide,5,7,1939,1274,728,546,1274,2,0,Detchd,1939.0,Unf,1.0
2458,70,RM,6000,BrkSide,6,6,1939,1232,608,624,1232,1,1,Attchd,1939.0,Unf,1.0
2459,45,RM,6120,BrkSide,5,7,1939,884,884,0,884,1,0,Detchd,1939.0,Unf,1.0
2460,50,RM,6240,BrkSide,6,5,1938,1409,861,548,1409,1,1,Detchd,1968.0,Unf,2.0
2461,50,RM,6240,BrkSide,5,8,1939,1322,899,423,1322,1,0,Detchd,1939.0,Unf,1.0
2462,50,RM,6240,BrkSide,5,7,1930,1426,1014,412,1426,1,0,Detchd,1930.0,Unf,1.0
2463,50,RM,6120,BrkSide,5,6,1926,1281,903,378,1281,1,0,Detchd,1926.0,Unf,2.0
2464,70,RM,7755,OldTown,6,8,1918,2264,1100,1164,2264,2,1,Detchd,1950.0,Unf,1.0
2465,50,RL,8850,BrkSide,6,7,1920,1376,752,624,1376,1,0,Detchd,1977.0,Unf,2.0
2466,50,RL,8550,BrkSide,5,5,1926,1316,960,356,1316,1,0,Detchd,1965.0,Unf,2.0
2467,70,RM,5700,OldTown,7,6,1929,1344,672,672,1344,1,1,Attchd,1979.0,Unf,2.0
2468,45,RM,5680,OldTown,5,4,1901,1173,933,240,1173,2,0,Detchd,1920.0,Unf,1.0
2469,50,RM,5680,OldTown,5,3,1901,1214,969,245,1214,1,0,Detchd,1920.0,Unf,1.0
2470,80,RM,13200,IDOTRR,6,6,1963,2294,1497,797,2294,3,0,Attchd,1963.0,Unf,2.0
2471,60,RM,9780,IDOTRR,7,9,1950,1952,976,976,1952,1,1,Detchd,1950.0,Fin,1.0
2472,50,RM,10320,IDOTRR,6,5,1915,2180,1138,1042,2180,1,1,Detchd,2006.0,Unf,2.0
2473,190,RM,4330,IDOTRR,4,6,1958,1315,838,477,1315,2,0,Detchd,1958.0,RFn,2.0
2474,50,RM,10320,IDOTRR,4,1,1910,1484,866,504,1484,2,0,Detchd,1910.0,Unf,1.0
2475,70,RL,12888,Sawyer,7,8,1937,2267,1262,1005,2267,1,1,Attchd,1937.0,Fin,2.0
2476,190,RL,4484,SWISU,5,6,1942,1282,778,504,1282,1,0,Detchd,1942.0,Unf,1.0
2477,190,RL,11235,Sawyer,5,5,1963,999,999,0,999,1,0,Detchd,1963.0,Unf,1.0
2478,85,RL,11235,Sawyer,5,5,1964,1452,1452,0,1452,1,0,Detchd,1964.0,Unf,2.0
2479,20,RL,14299,Sawyer,4,3,1964,1005,1005,0,1005,1,0,Detchd,1964.0,Unf,2.0
2480,80,RL,14149,Sawyer,5,8,1964,1020,1020,0,1020,2,0,Detchd,1970.0,Unf,2.0
2481,20,RL,11677,Sawyer,5,4,1966,1040,1040,0,1040,1,0,Attchd,1966.0,RFn,1.0
2482,190,RL,8425,Sawyer,5,6,1971,868,868,0,868,1,0,Detchd,1989.0,Unf,2.0
2483,20,RL,8665,Sawyer,5,5,1968,897,897,0,897,1,0,Attchd,1968.0,RFn,1.0
2484,20,RL,8398,Sawyer,5,5,1967,943,943,0,943,1,0,Detchd,1972.0,Unf,2.0
2485,20,RL,8169,Sawyer,5,7,1966,912,912,0,912,1,0,Detchd,1966.0,Unf,1.0
2486,20,RL,14175,Sawyer,5,5,1956,1375,1375,0,1375,1,0,Attchd,1956.0,Unf,1.0
2487,60,RL,16779,Sawyer,5,4,1920,2654,1567,1087,2654,3,0,Attchd,1946.0,Unf,2.0
2488,50,RL,6960,Sawyer,7,8,1940,1302,798,504,1302,1,1,Attchd,1940.0,Unf,1.0
2489,20,RL,11375,Sawyer,6,5,1954,1299,1299,0,1299,1,0,Attchd,1954.0,Unf,2.0
2490,20,RL,13770,Sawyer,5,6,1958,1176,1176,0,1176,1,0,Attchd,1958.0,Unf,1.0
2491,20,RL,9000,Sawyer,4,7,1945,998,998,0,998,1,0,2Types,1952.0,Unf,2.0
2492,20,RL,11075,ClearCr,6,5,1984,1522,1522,0,1522,2,0,Attchd,1984.0,Fin,2.0
2493,20,RL,17541,Edwards,5,7,1948,1325,1325,0,1325,2,0,Detchd,1996.0,Unf,2.0
2494,20,RL,22692,Edwards,5,5,1953,1630,1630,0,1630,2,0,Detchd,1953.0,Unf,2.0
2495,20,RL,17808,Edwards,4,5,1946,1242,1242,0,1242,1,0,Attchd,1946.0,Unf,1.0
2496,20,RL,12671,ClearCr,6,7,1954,2422,2422,0,2422,3,0,Attchd,1954.0,Fin,2.0
2497,50,RL,10512,Edwards,6,6,1954,1626,988,638,1626,1,1,Attchd,1954.0,Unf,1.0
2498,20,RL,5400,SWISU,5,5,1958,864,864,0,864,1,0,Attchd,1958.0,Unf,1.0
2499,30,RL,11515,Edwards,4,5,1958,943,943,0,943,1,0,Detchd,1958.0,Unf,1.0
2500,120,RL,3869,Edwards,5,6,1984,1038,1038,0,1038,2,0,Attchd,1984.0,RFn,1.0
2501,20,RL,9280,Edwards,5,6,1951,1342,1342,0,1342,1,0,Detchd,1951.0,Unf,1.0
2502,50,RL,11100,Edwards,5,6,1951,1480,1080,400,1480,1,0,Attchd,1951.0,Unf,1.0
2503,50,RL,7550,Edwards,4,5,1920,1362,986,376,1362,2,0,Detchd,1920.0,Unf,1.0
2504,50,RL,23920,SawyerW,6,5,1984,1822,1105,717,1822,2,0,Attchd,1984.0,Unf,2.0
2505,60,RL,9317,SawyerW,7,5,1994,1958,1029,929,1958,2,1,Attchd,1994.0,RFn,2.0
2506,20,RL,9178,CollgCr,8,5,2007,1651,1651,0,1651,2,0,Attchd,2007.0,Fin,3.0
2507,20,RL,10481,CollgCr,8,5,2006,2140,2140,0,2140,2,1,Attchd,2006.0,Fin,3.0
2508,20,RL,10235,CollgCr,8,5,2007,1651,1651,0,1651,2,0,Attchd,2007.0,RFn,3.0
2509,20,RL,11750,CollgCr,7,5,2005,1546,1546,0,1546,2,0,Attchd,2005.0,RFn,3.0
2510,20,RL,8760,CollgCr,8,5,2006,1500,1500,0,1500,2,0,Attchd,2005.0,RFn,2.0
2511,20,RL,7242,CollgCr,7,5,2005,1270,1270,0,1270,2,0,Attchd,2005.0,RFn,2.0
2512,60,RL,9316,CollgCr,7,5,2005,1795,879,916,1795,2,1,Attchd,2005.0,RFn,2.0
2513,60,RL,8883,SawyerW,7,5,1988,1873,946,927,1873,2,1,Attchd,1988.0,RFn,2.0
2514,20,RL,20064,ClearCr,8,6,1976,1743,1743,0,1743,0,1,Attchd,1976.0,Fin,2.0
2515,20,RL,14217,CollgCr,5,5,1994,1022,1022,0,1022,1,0,Detchd,1995.0,Unf,2.0
2516,60,RL,10021,CollgCr,6,6,1997,1308,646,662,1308,2,1,Attchd,1997.0,RFn,2.0
2517,20,RL,8428,CollgCr,5,7,1994,990,990,0,990,1,0,Detchd,1995.0,Unf,1.0
2518,20,RL,16561,CollgCr,5,5,1996,1097,1097,0,1097,1,1,Attchd,1996.0,Unf,1.0
2519,60,RL,10820,CollgCr,7,5,1999,1873,988,885,1873,2,1,Attchd,1999.0,RFn,2.0
2520,60,RL,12352,CollgCr,7,5,1998,1753,853,900,1753,2,1,Attchd,1998.0,RFn,2.0
2521,60,RL,9543,CollgCr,7,5,2001,1690,845,845,1690,2,1,Attchd,2001.0,RFn,2.0
2522,60,RL,8826,CollgCr,7,5,2000,1842,985,857,1842,2,1,Attchd,2000.0,Fin,2.0
2523,20,RL,11800,CollgCr,5,5,1974,894,894,0,894,1,0,Attchd,1974.0,Unf,2.0
2524,80,RL,8660,CollgCr,5,5,1976,1025,1025,0,1025,2,0,Detchd,1979.0,Unf,2.0
2525,80,RL,9720,CollgCr,5,7,1977,1009,1009,0,1009,2,0,Detchd,1977.0,Unf,2.0
2526,20,RL,8982,CollgCr,5,5,1977,1040,1040,0,1040,1,1,Detchd,1977.0,Unf,2.0
2527,20,RL,16300,CollgCr,5,4,1977,907,907,0,907,1,0,Attchd,1977.0,RFn,1.0
2528,20,RL,9675,CollgCr,5,6,1975,879,879,0,879,1,0,Attchd,1975.0,Unf,2.0
2529,20,RL,7200,CollgCr,5,5,1972,864,864,0,864,1,0,Detchd,1977.0,Fin,2.0
2530,20,RL,7200,CollgCr,4,8,1972,875,875,0,875,1,0,Detchd,1975.0,Unf,2.0
2531,20,RL,11354,CollgCr,7,5,2000,1673,1673,0,1673,2,0,Attchd,2000.0,RFn,2.0
2532,60,RL,8749,CollgCr,7,5,2003,1932,992,940,1932,2,1,Attchd,2003.0,RFn,2.0
2533,60,RL,8158,CollgCr,7,5,2002,1729,860,869,1729,2,1,Attchd,2002.0,Fin,2.0
2534,20,RL,11927,CollgCr,8,5,1994,1592,1592,0,1592,2,0,Attchd,1994.0,Fin,2.0
2535,60,RL,12728,CollgCr,8,5,2001,2439,1531,908,2439,2,1,Attchd,2001.0,Fin,2.0
2536,60,RL,15295,CollgCr,7,5,1996,1992,1212,780,1992,2,1,Attchd,1996.0,RFn,2.0
2537,20,RL,17227,CollgCr,8,5,1999,1341,1341,0,1341,1,1,Attchd,1999.0,RFn,2.0
2538,60,RL,8145,CollgCr,7,5,2007,1476,738,738,1476,2,1,Attchd,2007.0,RFn,2.0
2539,20,RL,8769,CollgCr,7,5,2005,1190,1190,0,1190,2,0,Attchd,2005.0,RFn,2.0
2540,20,RL,8334,CollgCr,6,5,2006,1330,1330,0,1330,2,0,Attchd,2006.0,Fin,2.0
2541,60,RL,8333,CollgCr,7,5,2006,1491,738,753,1491,2,1,Attchd,2006.0,RFn,2.0
2542,60,RL,9045,CollgCr,5,5,2005,1536,768,768,1536,2,1,Attchd,2005.0,Fin,2.0
2543,85,RL,9825,Edwards,5,5,1967,936,936,0,936,1,0,Attchd,1967.0,Unf,1.0
2544,20,RL,8308,Edwards,4,6,1963,1088,1088,0,1088,1,0,Detchd,2002.0,Unf,2.0
2545,50,RL,16287,Edwards,5,6,1925,1351,901,450,1351,1,0,Detchd,1975.0,Unf,2.0
2546,20,RL,8240,Edwards,6,6,1960,1179,1179,0,1179,1,0,Attchd,1960.0,Fin,2.0
2547,80,RL,6285,Edwards,6,6,1976,1044,1044,0,1044,1,0,Detchd,1976.0,Unf,2.0
2548,90,RL,9555,Edwards,5,6,1979,2233,1100,1133,2233,2,1,Attchd,1979.0,Fin,2.0
2549,60,RL,7023,Edwards,5,5,2005,1408,734,674,1408,2,1,BuiltIn,2005.0,Fin,2.0
2550,20,RL,39290,Edwards,10,5,2008,5095,5095,0,5095,2,1,Attchd,2008.0,Fin,3.0
2551,180,RM,3675,Edwards,6,5,2005,1072,1072,0,1072,1,0,Basment,2005.0,Fin,2.0
2552,20,RL,6400,Edwards,5,7,1959,960,960,0,960,1,0,Detchd,1959.0,Unf,1.0
2553,90,RL,6882,Edwards,4,3,1955,1152,1152,0,1152,2,0,,,,0.0
2554,90,RL,8741,Edwards,5,6,1946,1195,1195,0,1195,2,0,,,,0.0
2555,40,RL,10042,Edwards,6,8,1920,865,740,125,865,1,0,Detchd,1920.0,Unf,1.0
2556,20,RL,8172,Edwards,4,5,1955,768,768,0,768,1,0,Detchd,1959.0,Unf,1.0
2557,20,RL,8172,Edwards,4,5,1955,864,864,0,864,1,0,Detchd,1996.0,Unf,2.0
2558,90,RL,10890,SWISU,5,6,1923,2592,1296,1296,2592,2,0,,,,0.0
2559,30,RL,7223,Crawfor,5,5,1926,1422,1422,0,1422,1,0,Detchd,1973.0,Unf,1.0
2560,50,RL,6821,Crawfor,6,7,1921,1298,759,539,1298,2,0,Detchd,1994.0,Unf,1.0
2561,70,RL,4000,Crawfor,7,8,1930,1098,567,531,1098,1,0,Detchd,1930.0,Unf,1.0
2562,70,RL,6720,Crawfor,6,7,1921,1436,851,585,1436,1,0,Detchd,1992.0,Unf,1.0
2563,70,RL,7155,Crawfor,6,8,1926,1461,686,775,1461,1,0,Detchd,1926.0,Unf,1.0
2564,70,RL,7230,Crawfor,7,7,1927,1718,867,851,1718,2,1,Detchd,1927.0,Unf,2.0
2565,20,RL,13108,Crawfor,5,5,1951,1226,1226,0,1226,1,1,Attchd,1951.0,Fin,2.0
2566,50,RL,7810,Crawfor,4,6,1930,1755,1230,525,1755,2,0,Detchd,1930.0,Unf,1.0
2567,190,RL,6221,Crawfor,5,5,1941,1355,760,595,1355,2,0,Detchd,1966.0,Unf,2.0
2568,20,RL,25485,Crawfor,6,4,1960,1560,1560,0,1560,1,1,Attchd,1960.0,RFn,2.0
2569,20,RL,21579,Crawfor,6,6,1968,1488,1488,0,1488,2,0,Attchd,1968.0,RFn,2.0
2570,160,RM,1782,Blueste,6,6,1980,1045,529,516,1045,1,0,Detchd,1980.0,Unf,2.0
2571,20,RL,17871,Crawfor,4,5,1995,1680,1680,0,1680,2,0,Attchd,1996.0,Unf,2.0
2572,120,RM,3907,Blueste,8,5,1988,1020,1020,0,1020,1,0,Attchd,1988.0,Unf,2.0
2573,20,RL,20693,Crawfor,7,5,1971,1696,1696,0,1696,2,0,Attchd,1971.0,Fin,2.0
2574,20,RL,18044,Crawfor,8,5,1986,2726,2726,0,2726,2,1,Attchd,1986.0,Fin,2.0
2575,50,RM,7000,IDOTRR,6,7,1940,1215,720,495,1215,1,0,Detchd,1965.0,Fin,2.0
2576,50,RM,7288,IDOTRR,5,7,1925,1601,936,665,1601,2,0,,,,0.0
2577,70,RM,9060,IDOTRR,5,6,1923,1828,942,886,1828,2,0,Detchd,,,
2578,30,RM,3672,IDOTRR,5,7,1922,816,816,0,816,1,0,Detchd,1922.0,Unf,1.0
2579,50,RM,11067,IDOTRR,2,4,1939,845,640,0,845,1,0,Detchd,1950.0,Unf,1.0
2580,190,C (all),8250,IDOTRR,5,6,1895,1991,1034,957,1991,2,0,,,,0.0
2581,20,C (all),6565,IDOTRR,4,6,1957,1073,1073,0,1073,1,0,Detchd,1985.0,Unf,2.0
2582,30,C (all),6060,IDOTRR,5,9,1930,1001,1001,0,1001,1,0,Detchd,1930.0,Unf,1.0
2583,120,RM,5568,Crawfor,8,5,2006,1625,1625,0,1625,2,0,Attchd,2006.0,Fin,2.0
2584,85,RL,12150,Mitchel,6,6,1979,1299,1299,0,1299,2,0,BuiltIn,1979.0,RFn,2.0
2585,20,RL,10000,Mitchel,5,5,2002,1392,1392,0,1392,2,0,Attchd,2002.0,Fin,3.0
2586,20,RL,12864,Mitchel,7,5,2002,1409,1409,0,1409,1,1,Attchd,2002.0,RFn,2.0
2587,20,RL,9928,Mitchel,7,5,1991,1478,1478,0,1478,2,0,Attchd,1991.0,Unf,2.0
2588,80,RL,8750,Mitchel,7,6,1975,918,918,0,918,1,0,Attchd,1975.0,Unf,1.0
2589,85,RL,8410,Mitchel,6,6,1974,1026,1026,0,1026,1,0,Attchd,1974.0,Unf,2.0
2590,120,RL,4054,Timber,7,6,1987,1501,1501,0,1501,2,0,Attchd,1987.0,Fin,2.0
2591,20,RL,19958,Timber,6,8,1958,2279,2279,0,2279,2,1,Attchd,1958.0,RFn,2.0
2592,20,RL,8368,Timber,7,5,2006,1689,1689,0,1689,2,0,Attchd,2007.0,Fin,2.0
2593,20,RL,8298,Timber,8,5,2006,1564,1564,0,1564,2,0,Attchd,2207.0,RFn,2.0
2594,20,RL,10331,Timber,7,7,1985,1240,1240,0,1240,2,0,Attchd,1985.0,Unf,2.0
2595,20,RL,6718,Timber,8,5,2001,1312,1312,0,1312,2,0,Attchd,2001.0,Unf,2.0
2596,20,RL,11305,Timber,8,5,2002,1922,1922,0,1922,2,0,Attchd,2002.0,Fin,3.0
2597,20,RL,7777,Timber,6,5,1996,1491,1491,0,1491,2,0,Attchd,1996.0,Fin,2.0
2598,60,RL,11800,Timber,7,5,2003,2486,1146,1340,2486,3,1,BuiltIn,2003.0,Fin,2.0
2599,20,RL,12633,Timber,10,5,2006,1824,1824,0,1824,2,0,Attchd,2006.0,Fin,3.0
2600,20,RL,43500,Mitchel,3,5,1953,2034,2034,0,2034,1,0,2Types,1953.0,RFn,4.0
2601,120,RM,6710,Mitchel,6,5,1996,936,936,0,936,0,1,Attchd,1996.0,Fin,2.0
2602,160,RM,1504,MeadowV,4,4,1972,1092,546,546,1092,1,1,Attchd,1972.0,Unf,1.0
2603,180,RM,1533,MeadowV,4,5,1970,992,530,462,992,1,0,BuiltIn,1970.0,Fin,1.0
2604,160,RM,1495,MeadowV,4,6,1970,1092,546,546,1092,1,1,,,,0.0
2605,160,RM,1890,MeadowV,4,3,1976,1092,546,546,1092,1,1,Attchd,1976.0,Unf,1.0
2606,85,RL,9129,Mitchel,5,5,1977,1008,1008,0,1008,1,0,Attchd,1977.0,Fin,2.0
2607,80,RL,15957,Mitchel,6,6,1977,1356,1356,0,1356,2,0,Attchd,1977.0,Fin,2.0
2608,20,RL,33983,Mitchel,5,6,1977,1676,1676,0,1676,1,1,Attchd,1977.0,RFn,2.0
2609,60,RL,8286,Mitchel,5,7,1977,1432,716,716,1432,1,1,Attchd,1977.0,Fin,2.0
2610,85,RL,6723,Mitchel,5,7,1971,796,796,0,796,1,0,,,,0.0
2611,20,RL,27697,Mitchel,4,3,1961,1608,1608,0,1608,1,0,Attchd,1961.0,Unf,1.0
2612,20,RL,11000,Mitchel,5,6,1976,1178,1178,0,1178,1,1,Attchd,1976.0,Unf,2.0
2613,20,RL,11625,Mitchel,5,7,1983,816,816,0,816,1,0,Attchd,1983.0,Fin,1.0
2614,20,RL,10447,Mitchel,5,6,1984,887,887,0,887,1,0,Attchd,1984.0,RFn,1.0
2615,20,RL,11027,NAmes,6,5,1954,1293,1293,0,1293,2,0,Attchd,1954.0,RFn,2.0
2616,20,RL,10533,NAmes,6,6,1956,1024,1024,0,1024,1,0,Attchd,1956.0,Unf,1.0
2617,20,RL,11765,NAmes,5,5,1957,1797,1797,0,1797,1,1,Attchd,1957.0,Unf,3.0
2618,20,RL,39384,NAmes,6,6,1957,1390,1390,0,1390,1,1,Attchd,1957.0,Unf,2.0
2619,20,RL,11727,NAmes,7,6,1969,1851,1851,0,1851,2,0,Attchd,1969.0,Fin,2.0
2620,60,RL,8238,Gilbert,6,5,1997,1525,813,712,1525,2,1,Attchd,1997.0,Fin,2.0
2621,60,RL,13041,Gilbert,6,5,1995,1671,781,890,1671,2,1,Attchd,1995.0,Fin,2.0
2622,60,RL,9783,Gilbert,6,5,1996,1776,821,955,1776,2,1,BuiltIn,1996.0,Fin,2.0
2623,60,RL,13128,Gilbert,8,5,2005,2064,1074,990,2064,2,1,Attchd,2005.0,Fin,2.0
2624,60,RL,13751,Gilbert,7,5,2005,2212,1700,512,2212,2,1,Attchd,2006.0,Fin,3.0
2625,160,RL,13108,StoneBr,8,5,1994,2687,2079,608,2687,2,1,Attchd,1994.0,Fin,2.0
2626,20,RL,8076,Gilbert,6,6,1993,1169,1169,0,1169,2,0,Attchd,1993.0,Fin,2.0
2627,120,RL,3701,StoneBr,8,5,1987,1204,1204,0,1204,2,0,Attchd,1987.0,RFn,2.0
2628,60,RL,16023,StoneBr,9,5,2005,2798,1414,1384,2798,3,1,BuiltIn,2005.0,Fin,3.0
2629,60,RL,18062,StoneBr,10,5,2006,3390,1528,1862,3390,3,1,BuiltIn,2006.0,Fin,3.0
2630,60,RL,12292,StoneBr,9,5,2006,2473,1102,1371,2473,2,1,BuiltIn,2006.0,Fin,3.0
2631,60,RL,16052,StoneBr,10,5,2006,2698,1850,848,2698,2,1,Attchd,2006.0,RFn,3.0
2632,60,RL,15922,StoneBr,9,5,2005,2795,1390,1405,2795,3,1,BuiltIn,2005.0,Fin,3.0
2633,120,RL,8147,StoneBr,9,5,2005,1714,1714,0,1714,2,0,Attchd,2005.0,Fin,2.0
2634,20,RL,18261,StoneBr,9,5,2005,2000,2000,0,2000,2,1,Attchd,2005.0,Unf,3.0
2635,85,RL,10464,NWAmes,6,6,1980,1102,1102,0,1102,1,0,Attchd,1980.0,RFn,2.0
2636,60,RL,10530,NWAmes,7,5,1978,1857,945,912,1857,2,1,Attchd,1978.0,RFn,2.0
2637,85,RL,9927,NWAmes,7,5,1976,1083,1083,0,1083,1,0,Attchd,1976.0,RFn,2.0
2638,60,FV,9512,Somerst,7,5,2005,2318,960,1358,2318,2,1,BuiltIn,2005.0,Fin,2.0
2639,80,RL,10530,NWAmes,6,6,1975,1875,1109,766,1875,3,0,Attchd,1975.0,RFn,2.0
2640,20,RL,10000,NWAmes,6,6,1974,1103,1103,0,1103,2,0,Attchd,1974.0,Unf,2.0
2641,20,RL,7200,NAmes,4,4,1971,874,874,0,874,1,0,Detchd,1995.0,Unf,2.0
2642,120,RH,8773,NAmes,6,5,2002,1419,1419,0,1419,2,0,Attchd,2002.0,Fin,2.0
2643,160,RM,2760,BrDale,6,5,1973,1092,525,567,1092,1,1,Detchd,1973.0,Unf,2.0
2644,160,RM,2160,BrDale,5,6,1973,1365,765,600,1365,1,1,Attchd,1973.0,Unf,2.0
2645,160,RM,1890,BrDale,6,7,1972,1030,494,536,1030,1,1,Detchd,1973.0,Unf,1.0
2646,160,RM,1680,BrDale,6,5,1972,948,483,465,948,1,1,Detchd,1972.0,Unf,1.0
2647,160,RM,1680,BrDale,6,5,1972,1092,525,567,1092,1,1,Detchd,1972.0,Unf,1.0
2648,120,RL,4043,NPkVill,6,5,1975,1069,1069,0,1069,2,0,Attchd,1975.0,RFn,2.0
2649,20,RL,7514,NAmes,5,7,1967,1387,1387,0,1387,1,0,Attchd,1974.0,RFn,1.0
2650,120,RL,2280,NPkVill,7,7,1976,1055,1055,0,1055,2,0,Attchd,1976.0,Unf,1.0
2651,160,RL,2179,NPkVill,6,5,1976,1456,855,601,1456,2,1,Attchd,1976.0,RFn,2.0
2652,60,RL,16387,NridgHt,9,5,2006,2589,1738,851,2589,2,1,Attchd,2006.0,RFn,3.0
2653,20,RL,16163,NridgHt,8,5,2004,1618,1618,0,1618,2,0,Attchd,2004.0,Fin,3.0
2654,20,RL,12228,NridgHt,7,5,2006,1740,1740,0,1740,2,0,Attchd,2006.0,RFn,3.0
2655,20,RL,14780,NridgHt,9,5,2005,1868,1868,0,1868,2,0,Attchd,2005.0,Fin,3.0
2656,60,RL,13975,NridgHt,9,5,2005,2206,1117,1089,2206,2,1,BuiltIn,2005.0,Fin,3.0
2657,60,RL,9942,NridgHt,9,5,2005,2091,1625,466,2091,2,1,Attchd,2005.0,RFn,2.0
2658,60,RL,12867,NridgHt,8,5,2005,2253,1209,1044,2253,2,1,Attchd,2005.0,Fin,2.0
2659,60,RL,10672,NridgHt,8,5,2006,2389,1054,1335,2389,2,1,BuiltIn,2006.0,Fin,3.0
2660,60,RL,11643,NridgHt,8,5,2005,2358,1544,814,2358,2,1,BuiltIn,2005.0,Fin,3.0
2661,20,RL,13758,NridgHt,9,5,2005,1792,1792,0,1792,2,0,Attchd,2005.0,RFn,3.0
2662,20,RL,14828,NridgHt,9,5,2004,1780,1780,0,1780,2,0,Attchd,2004.0,Fin,3.0
2663,60,RL,13215,NridgHt,8,5,2004,1914,1426,488,1914,2,1,BuiltIn,2004.0,RFn,3.0
2664,120,RL,5911,NridgHt,9,5,2005,1565,1565,0,1565,2,0,Attchd,2005.0,RFn,2.0
2665,20,RL,7740,NridgHt,9,5,2006,1686,1686,0,1686,2,0,Attchd,2006.0,Fin,3.0
2666,120,RL,6373,NridgHt,9,5,2006,1666,1666,0,1666,2,0,Attchd,2006.0,RFn,2.0
2667,60,RL,10237,Gilbert,6,5,2005,1456,728,728,1456,2,1,Attchd,2005.0,Fin,2.0
2668,60,RL,10237,Gilbert,7,5,2006,1492,738,754,1492,2,1,Attchd,2006.0,Fin,2.0
2669,20,RL,11660,Gilbert,6,5,2006,1326,1326,0,1326,2,0,Attchd,2006.0,Fin,2.0
2670,60,RL,11631,Gilbert,8,5,2004,2373,1052,1321,2373,2,1,BuiltIn,2004.0,Fin,3.0
2671,60,RL,9073,Gilbert,7,5,2006,1492,738,754,1492,2,1,Attchd,2006.0,Fin,2.0
2672,120,RL,3087,Blmngtn,7,5,2006,1364,1364,0,1364,2,0,Attchd,2006.0,Fin,2.0
2673,120,RL,2938,Blmngtn,7,5,2002,1511,1511,0,1511,2,0,Attchd,2002.0,Fin,2.0
2674,120,RM,3072,Blmngtn,7,5,2004,1548,1548,0,1548,2,0,Attchd,2004.0,Fin,2.0
2675,120,RL,3010,Blmngtn,7,5,2005,1142,1142,0,1142,2,0,Attchd,2005.0,Fin,2.0
2676,60,RL,9171,Gilbert,7,5,2004,1598,848,750,1598,2,1,Attchd,2004.0,Fin,2.0
2677,60,RL,8658,Gilbert,6,5,2000,1889,1008,881,1889,2,1,Attchd,2000.0,Fin,2.0
2678,60,RL,12104,Gilbert,7,5,2006,2322,1082,1240,2322,3,1,Attchd,2006.0,RFn,3.0
2679,60,RL,9660,NoRidge,8,5,1998,1976,1079,897,1976,2,1,Attchd,1998.0,Fin,3.0
2680,60,RL,9545,NoRidge,8,5,2000,2234,1205,1029,2234,2,1,BuiltIn,2000.0,RFn,3.0
2681,60,RL,9233,NoRidge,9,5,2000,2855,1540,1315,2855,2,1,Attchd,2000.0,RFn,3.0
2682,60,RL,10019,NoRidge,8,5,1995,2726,1358,1368,2726,2,1,Attchd,1995.0,RFn,3.0
2683,60,RL,17242,NoRidge,9,5,1993,3500,1933,1567,3500,3,1,Attchd,1993.0,RFn,3.0
2684,60,RL,10236,NoRidge,8,5,1994,2494,1305,1189,2494,2,1,Attchd,1994.0,Fin,3.0
2685,60,RL,12585,NoRidge,8,5,1993,2799,1565,1234,2799,2,1,Attchd,1993.0,Fin,3.0
2686,60,RL,12447,Somerst,8,5,2005,1964,1116,848,1964,2,1,BuiltIn,2005.0,Fin,2.0
2687,20,RL,15218,Somerst,8,5,2006,1670,1670,0,1670,2,1,Attchd,2006.0,RFn,3.0
2688,20,RL,10936,Somerst,8,5,2006,1504,1504,0,1504,2,0,Attchd,2006.0,Fin,2.0
2689,20,FV,8640,Somerst,8,5,2006,1278,1278,0,1278,2,0,Attchd,2006.0,RFn,2.0
2690,60,FV,13162,Somerst,9,5,2006,2640,2036,604,2640,3,1,Attchd,2006.0,RFn,3.0
2691,60,FV,8125,Somerst,6,5,2005,1716,858,858,1716,2,1,Attchd,2005.0,RFn,2.0
2692,20,RL,7733,SawyerW,6,5,2005,1142,1142,0,1142,1,1,,,,0.0
2693,20,RL,11024,SawyerW,7,5,2005,1400,1400,0,1400,2,0,Attchd,2005.0,RFn,2.0
2694,20,RL,13072,SawyerW,6,5,2005,1131,1131,0,1131,1,1,,,,0.0
2695,60,RL,7800,SawyerW,7,5,2005,1686,891,795,1686,2,1,Attchd,2005.0,Fin,2.0
2696,60,RL,7632,SawyerW,7,5,2005,1585,831,754,1585,2,1,Attchd,2005.0,RFn,2.0
2697,60,RL,8304,SawyerW,6,5,1997,1837,941,896,1837,2,1,Attchd,1997.0,RFn,2.0
2698,60,RL,9370,SawyerW,6,5,1992,1731,844,887,1731,2,1,Attchd,1992.0,RFn,2.0
2699,120,RL,7175,SawyerW,6,5,1990,1398,1398,0,1398,2,0,Attchd,1990.0,RFn,2.0
2700,120,RL,7175,SawyerW,6,5,1991,1217,1217,0,1217,2,0,Attchd,1991.0,RFn,2.0
2701,60,RL,9019,SawyerW,6,5,1994,1320,636,684,1320,2,1,Attchd,1994.0,Fin,2.0
2702,20,RL,9100,Sawyer,5,4,1962,988,988,0,988,1,0,Detchd,1977.0,Unf,2.0
2703,90,RM,8927,Sawyer,6,6,1977,1654,1286,368,1654,2,0,Attchd,1977.0,RFn,2.0
2704,20,RL,9240,Sawyer,5,6,1962,1211,1211,0,1211,1,0,Detchd,1972.0,Unf,2.0
2705,20,RL,9308,Sawyer,5,5,1965,984,984,0,984,1,0,Attchd,1965.0,Unf,1.0
2706,20,RL,8450,Sawyer,5,6,1968,909,909,0,909,1,0,Attchd,1968.0,Unf,1.0
2707,20,RL,8638,Sawyer,5,6,1963,925,925,0,925,1,0,Detchd,1990.0,Unf,2.0
2708,20,RL,13052,Sawyer,5,6,1965,1024,1024,0,1024,1,1,Attchd,1965.0,Unf,1.0
2709,20,RL,8020,Sawyer,5,6,1964,912,912,0,912,1,0,,,,0.0
2710,20,RL,8789,Sawyer,5,6,1967,941,941,0,941,1,0,Attchd,1967.0,Unf,1.0
2711,80,RL,14330,Veenker,7,4,1974,2646,2151,495,2646,2,0,Attchd,1974.0,RFn,2.0
2712,60,RL,11025,NoRidge,8,5,1992,2826,1520,1306,2826,2,1,Attchd,1992.0,RFn,3.0
2713,120,FV,3628,Somerst,7,5,2004,1143,1143,0,1143,1,1,Attchd,2004.0,RFn,2.0
2714,160,FV,2544,Somerst,7,5,2005,1223,520,623,1223,2,1,Detchd,2005.0,RFn,2.0
2715,160,FV,2998,Somerst,6,5,2000,1524,768,756,1524,2,1,Detchd,2000.0,Unf,2.0
2716,160,FV,4447,Somerst,7,5,2003,1080,530,550,1080,2,1,Attchd,2003.0,RFn,2.0
2717,60,FV,8314,Somerst,7,5,1997,1694,854,840,1694,2,1,BuiltIn,1997.0,Unf,1.0
2718,20,FV,7180,Somerst,8,5,2001,1568,1568,0,1568,2,0,Attchd,2001.0,RFn,2.0
2719,190,RL,13110,NWAmes,5,6,1972,1193,1193,0,1193,2,0,Attchd,1972.0,Fin,2.0
2720,20,RL,10140,NWAmes,7,6,1967,1334,1334,0,1334,2,0,Attchd,1967.0,RFn,2.0
2721,20,RL,9600,NAmes,5,5,1968,1051,1051,0,1051,1,0,Attchd,1968.0,RFn,2.0
2722,60,RL,8640,NAmes,5,5,1968,1770,884,886,1770,1,1,Attchd,1968.0,RFn,2.0
2723,20,RL,9360,NAmes,6,7,1968,976,976,0,976,1,0,Attchd,1968.0,RFn,2.0
2724,85,RL,8400,NAmes,5,6,1968,898,898,0,898,1,0,Attchd,1968.0,RFn,1.0
2725,20,RL,9759,NAmes,5,5,1966,1051,1051,0,1051,1,0,Attchd,1966.0,RFn,1.0
2726,80,RL,9600,NAmes,5,7,1967,1141,1141,0,1141,1,0,Attchd,1967.0,Unf,1.0
2727,190,RL,8800,NAmes,6,7,1965,1565,1565,0,1565,2,0,Attchd,1965.0,RFn,1.0
2728,20,RL,10368,NAmes,6,6,1964,1488,1488,0,1488,1,1,Attchd,1964.0,Fin,2.0
2729,60,RL,9350,NAmes,5,6,1964,1440,720,720,1440,1,1,Attchd,1964.0,Fin,2.0
2730,20,RL,10800,NAmes,5,7,1960,1248,1248,0,1248,1,0,Attchd,1960.0,Unf,1.0
2731,30,RL,8550,NAmes,6,8,1934,816,816,0,816,1,0,Attchd,1949.0,Unf,1.0
2732,20,RL,9724,NAmes,5,7,1947,1043,1043,0,1043,1,0,Detchd,1947.0,Unf,1.0
2733,20,RL,9600,NAmes,5,6,1961,1433,1433,0,1433,1,0,Attchd,1961.0,Unf,2.0
2734,20,RL,10858,NAmes,5,6,1952,1624,1624,0,1624,1,0,Attchd,1952.0,RFn,1.0
2735,20,RL,9600,NAmes,5,5,1951,1216,1216,0,1216,1,0,Attchd,1951.0,RFn,1.0
2736,60,RL,9462,NAmes,5,6,1949,1728,1024,704,1728,1,1,Attchd,1949.0,Unf,1.0
2737,20,RL,9888,NAmes,5,6,1954,936,936,0,936,1,0,Attchd,1954.0,Unf,1.0
2738,90,RL,8917,NAmes,5,5,1967,1584,1584,0,1584,2,0,Detchd,1967.0,Unf,2.0
2739,80,RL,12700,NAmes,6,5,1964,1246,1246,0,1246,1,0,Attchd,1964.0,RFn,2.0
2740,20,RL,9723,NAmes,6,7,1963,1008,1008,0,1008,1,0,Attchd,1963.0,RFn,2.0
2741,20,RL,8400,NAmes,5,5,1957,1364,1364,0,1364,1,1,Attchd,1957.0,RFn,1.0
2742,20,RL,9610,NAmes,6,6,1958,1336,1336,0,1336,1,1,Attchd,1958.0,RFn,2.0
2743,80,RL,10000,NAmes,5,6,1956,1370,1370,0,1370,1,0,Basment,1956.0,RFn,1.0
2744,20,RL,10152,NAmes,6,6,1956,1124,1124,0,1124,1,0,Attchd,1956.0,Fin,1.0
2745,20,RL,8092,NAmes,6,8,1954,1050,1050,0,1050,1,0,Attchd,1954.0,RFn,1.0
2746,20,RL,12778,NAmes,5,6,1952,1008,1008,0,1008,1,0,Attchd,1952.0,RFn,1.0
2747,20,RL,10170,NAmes,6,6,1951,1575,1575,0,1575,1,1,Attchd,1951.0,Unf,2.0
2748,80,RL,7700,NAmes,5,7,1956,1145,1145,0,1145,1,0,Detchd,1993.0,Unf,2.0
2749,20,RL,11050,NAmes,5,5,1956,1005,1005,0,1005,1,0,Attchd,1956.0,Unf,1.0
2750,20,RL,13600,NAmes,5,6,1955,1056,1056,0,1056,1,1,Attchd,1955.0,Fin,1.0
2751,20,RL,15428,NAmes,5,6,1951,884,884,0,884,1,0,Attchd,1951.0,Fin,1.0
2752,30,RL,21299,NAmes,7,5,1941,2039,2039,0,2039,1,1,2Types,1941.0,Unf,3.0
2753,20,RL,13300,NAmes,5,5,1956,1384,1384,0,1384,1,0,Attchd,2001.0,Unf,2.0
2754,190,RL,22136,OldTown,5,5,1925,2640,1392,1248,2640,2,1,Attchd,1977.0,RFn,3.0
2755,50,RL,7500,NAmes,6,6,1947,1312,900,412,1312,1,1,Detchd,1953.0,Unf,2.0
2756,30,RL,10410,OldTown,3,8,1930,713,713,0,713,1,0,Detchd,1936.0,Unf,1.0
2757,30,RL,10914,NAmes,3,3,1929,715,715,0,715,1,0,Detchd,1967.0,Unf,2.0
2758,50,RL,7008,OldTown,4,8,1900,720,448,272,720,1,0,Attchd,1900.0,Unf,1.0
2759,70,RL,7200,OldTown,6,8,1915,1595,774,821,1595,2,0,Detchd,1974.0,Unf,2.0
2760,50,RL,10818,OldTown,4,4,1910,1760,981,779,1760,1,1,Detchd,1935.0,Unf,2.0
2761,80,RL,10184,NAmes,6,5,1963,1146,1146,0,1146,1,0,Attchd,1963.0,Unf,1.0
2762,20,RL,9510,NAmes,6,5,1962,1207,1207,0,1207,1,1,Attchd,1962.0,RFn,1.0
2763,20,RL,10800,NAmes,6,6,1961,1773,1773,0,1773,2,0,Attchd,1961.0,RFn,2.0
2764,20,RL,11650,NAmes,7,5,1959,1472,1472,0,1472,2,0,Attchd,1959.0,Unf,2.0
2765,60,RL,18275,NAmes,7,8,1962,2448,1900,548,2448,3,0,Attchd,1962.0,RFn,2.0
2766,50,RL,12144,NAmes,4,6,1950,1521,910,611,1521,1,1,Detchd,1950.0,Unf,1.0
2767,90,RL,8544,NAmes,3,4,1950,1040,1040,0,1040,2,0,Detchd,1950.0,Unf,2.0
2768,90,RL,8512,NAmes,5,5,1960,1556,1556,0,1556,2,0,,,,0.0
2769,20,RL,7000,NAmes,5,4,1961,1150,1150,0,1150,1,0,Attchd,1961.0,RFn,1.0
2770,20,RL,7400,NAmes,7,6,1962,1045,1045,0,1045,1,0,Detchd,1962.0,Unf,2.0
2771,20,RL,7000,NAmes,5,6,1962,864,864,0,864,1,0,Attchd,1962.0,Unf,1.0
2772,190,RL,7000,NAmes,5,5,1962,1025,1025,0,1025,1,0,,,,0.0
2773,70,RM,9856,OldTown,5,8,1900,2014,1007,1007,2014,2,0,Detchd,1900.0,Unf,2.0
2774,50,RM,9600,OldTown,5,6,1948,1668,1226,442,1668,1,0,Detchd,1948.0,Unf,1.0
2775,50,RM,5520,OldTown,4,6,1920,1657,1147,510,1657,1,0,Detchd,1920.0,Unf,1.0
2776,50,RM,9600,OldTown,6,8,1900,1416,940,476,1416,1,0,Detchd,1956.0,Unf,2.0
2777,70,RM,6451,OldTown,7,7,1900,1428,848,580,1428,1,0,Detchd,1985.0,Fin,2.0
2778,70,RM,3960,OldTown,7,8,1930,1004,502,502,1004,1,0,Detchd,1930.0,Unf,1.0
2779,190,RM,7745,OldTown,4,6,1900,1951,1084,867,1951,2,0,Detchd,1993.0,Unf,2.0
2780,30,RM,7741,OldTown,6,5,1924,1032,1032,0,1032,1,0,Detchd,1995.0,Unf,1.0
2781,30,RM,5633,OldTown,5,7,1925,844,844,0,844,1,0,Detchd,1925.0,Unf,1.0
2782,20,RM,7200,OldTown,4,5,1950,864,864,0,864,1,0,Detchd,1952.0,RFn,1.0
2783,70,RM,7614,OldTown,3,5,1905,1376,714,662,1376,1,0,Detchd,1930.0,Unf,1.0
2784,190,RM,6000,OldTown,5,7,1955,960,960,0,960,1,0,Detchd,1976.0,Unf,2.0
2785,50,RM,6000,OldTown,5,7,1924,1566,816,750,1566,1,1,Detchd,1976.0,Unf,2.0
2786,30,RM,7830,OldTown,3,5,1921,492,492,0,492,1,0,Detchd,1921.0,Unf,1.0
2787,50,RM,9576,OldTown,6,7,1945,1182,885,297,1182,1,1,Detchd,1945.0,Unf,1.0
2788,30,RM,5747,OldTown,3,4,1920,840,840,0,840,1,0,Detchd,1938.0,Unf,1.0
2789,75,RM,6300,OldTown,7,6,1910,2104,1226,878,2104,2,0,Detchd,1910.0,Unf,2.0
2790,90,RM,5976,OldTown,5,7,1920,1248,624,624,1248,2,0,,,,0.0
2791,20,RM,9750,OldTown,5,5,1958,960,960,0,960,1,0,Detchd,2002.0,Unf,2.0
2792,50,C (all),4761,IDOTRR,3,3,1918,1020,1020,0,1020,1,0,,,,0.0
2793,70,RL,11737,BrkSide,6,7,1924,1827,1017,810,1827,1,0,Detchd,1943.0,Unf,1.0
2794,50,RM,6120,BrkSide,3,5,1930,1162,728,434,1162,1,0,Detchd,1930.0,Unf,1.0
2795,50,RM,6120,BrkSide,5,7,1930,1324,741,583,1324,1,0,Detchd,1930.0,Unf,1.0
2796,30,RL,11672,BrkSide,5,5,1925,816,816,0,816,1,0,Detchd,1925.0,Unf,1.0
2797,50,RM,33120,OldTown,6,5,1962,2486,1611,875,2486,2,0,Detchd,1962.0,Unf,2.0
2798,50,RM,10320,IDOTRR,4,5,1924,1430,834,596,1430,2,0,Detchd,1924.0,Unf,2.0
2799,70,RM,7518,IDOTRR,5,8,1910,1330,665,665,1330,1,0,Detchd,2001.0,Unf,1.0
2800,30,RM,9000,IDOTRR,5,4,1919,819,819,0,819,1,0,,,,0.0
2801,30,RM,7200,IDOTRR,6,6,1930,984,984,0,984,1,0,Detchd,1930.0,Unf,1.0
2802,50,RL,12375,Sawyer,5,5,1951,1422,1081,341,1422,1,0,Detchd,1951.0,Unf,1.0
2803,90,RL,11136,Sawyer,6,5,1964,1921,1921,0,1921,2,0,Detchd,1964.0,Unf,2.0
2804,20,RL,21370,Sawyer,5,5,1950,1640,1640,0,1640,1,0,Attchd,1950.0,RFn,2.0
2805,30,RL,8250,Edwards,5,7,1935,1032,1032,0,1032,1,0,Detchd,1939.0,Unf,1.0
2806,30,RL,5220,SWISU,5,3,1936,879,879,0,879,1,0,Detchd,1936.0,Unf,1.0
2807,20,RL,5500,SWISU,7,5,2004,1073,1073,0,1073,2,0,Detchd,2004.0,Unf,1.0
2808,20,RL,11327,Sawyer,5,6,1967,1064,1064,0,1064,1,0,Attchd,1967.0,Unf,2.0
2809,80,RL,10366,Sawyer,6,7,1964,934,934,0,934,1,0,Attchd,1964.0,Unf,1.0
2810,20,RL,9000,Sawyer,5,6,1966,1059,1059,0,1059,1,0,Attchd,1966.0,Fin,1.0
2811,20,RL,9535,Sawyer,5,5,1967,1458,1458,0,1458,1,1,Attchd,1967.0,Unf,2.0
2812,80,RL,7176,Sawyer,6,6,1978,1040,1040,0,1040,1,0,Detchd,1979.0,Unf,2.0
2813,90,RL,9662,Sawyer,5,4,1977,1967,1967,0,1967,2,0,Attchd,1977.0,Fin,2.0
2814,90,RL,8235,Sawyer,5,4,1977,1949,1949,0,1949,2,0,Attchd,1977.0,RFn,2.0
2815,30,RL,17529,Sawyer,5,5,1924,872,872,0,872,1,0,Detchd,1924.0,Unf,1.0
2816,20,RL,20355,ClearCr,7,6,1967,1830,1830,0,1830,1,0,Attchd,1967.0,Unf,2.0
2817,20,RL,13050,ClearCr,5,6,1963,1000,1000,0,1000,1,0,Attchd,1993.0,Unf,2.0
2818,85,RL,10820,Sawyer,5,7,1971,810,810,0,810,1,0,Detchd,1973.0,Unf,2.0
2819,150,RL,1700,ClearCr,7,5,1980,1700,880,680,1700,2,1,Basment,1980.0,Fin,1.0
2820,20,RL,9375,Edwards,4,5,1954,1350,1350,0,1350,1,1,Attchd,1954.0,RFn,2.0
2821,50,RL,6488,Edwards,5,5,1942,1150,799,351,1150,1,0,BuiltIn,1942.0,Unf,1.0
2822,70,RL,19950,Edwards,6,7,1928,2009,1337,672,2009,2,0,2Types,1928.0,Unf,3.0
2823,75,RL,19800,Edwards,6,8,1935,3672,1836,1836,3672,3,1,Detchd,1993.0,Unf,2.0
2824,80,RL,11679,Edwards,5,5,1962,1560,1560,0,1560,2,0,Attchd,1962.0,Fin,2.0
2825,20,RL,12048,Edwards,5,6,1952,1488,1488,0,1488,1,0,Attchd,2002.0,RFn,2.0
2826,20,RL,10519,Edwards,5,8,1955,1057,1057,0,1057,1,0,Attchd,1955.0,Unf,1.0
2827,50,RL,9525,Edwards,6,5,1953,1609,1068,541,1609,1,1,Attchd,1953.0,Unf,1.0
2828,60,RL,12128,SawyerW,6,4,1989,2559,1313,1246,2559,2,1,Attchd,1989.0,RFn,2.0
2829,90,RL,9069,SawyerW,6,8,1993,1440,1440,0,1440,2,0,Attchd,1993.0,Unf,4.0
2830,60,RL,11003,CollgCr,7,5,2005,1876,1308,568,1876,2,1,BuiltIn,2005.0,RFn,3.0
2831,20,RL,7488,CollgCr,7,5,2005,1208,1208,0,1208,2,0,Attchd,2005.0,RFn,2.0
2832,20,RL,13377,CollgCr,6,5,2006,1846,1846,0,1846,2,0,Attchd,2006.0,RFn,2.0
2833,20,RL,11645,CollgCr,8,5,2005,1590,1590,0,1590,2,1,Attchd,2005.0,Fin,3.0
2834,60,RL,10984,CollgCr,7,5,2005,1809,945,864,1809,2,1,Attchd,2005.0,RFn,2.0
2835,20,RL,9316,CollgCr,7,5,2005,1614,1614,0,1614,2,0,Attchd,2005.0,Fin,2.0
2836,60,RL,9316,CollgCr,7,5,2005,1596,784,812,1596,2,1,Attchd,2005.0,RFn,2.0
2837,20,RL,12000,ClearCr,6,5,1968,1388,1388,0,1388,2,0,Attchd,1968.0,RFn,2.0
2838,20,RL,13015,CollgCr,5,6,1996,1100,1100,0,1100,1,1,Attchd,1996.0,RFn,2.0
2839,60,RL,12438,CollgCr,6,5,1995,1499,795,704,1499,2,1,Attchd,1995.0,RFn,2.0
2840,20,RL,8685,CollgCr,7,5,1998,1425,1425,0,1425,2,0,Attchd,1998.0,RFn,2.0
2841,60,RL,9272,CollgCr,7,5,1999,1749,856,893,1749,2,1,Attchd,1999.0,RFn,2.0
2842,60,RL,13426,CollgCr,7,5,1999,1779,951,828,1779,2,1,Attchd,1999.0,Fin,2.0
2843,60,RL,8340,CollgCr,6,6,1977,1388,686,702,1388,1,1,Attchd,1977.0,Unf,1.0
2844,80,RL,10385,CollgCr,6,6,1978,1282,1282,0,1282,2,0,Detchd,1989.0,Unf,3.0
2845,20,RL,7200,CollgCr,5,8,1972,864,864,0,864,1,0,Detchd,1977.0,Unf,1.0
2846,60,RL,9930,CollgCr,7,5,2002,1762,878,884,1762,2,1,Attchd,2002.0,Fin,2.0
2847,60,RL,9468,CollgCr,6,5,1999,1755,840,915,1755,2,1,Attchd,1999.0,RFn,2.0
2848,20,RL,11088,CollgCr,8,5,2002,1358,1358,0,1358,1,1,Attchd,2002.0,Unf,2.0
2849,60,RL,8726,CollgCr,7,5,2002,1909,872,1037,1909,2,1,BuiltIn,2002.0,RFn,2.0
2850,60,RL,10566,CollgCr,8,5,1999,2214,1090,1124,2214,2,1,Attchd,1999.0,Fin,3.0
2851,60,RL,21533,CollgCr,7,5,1996,2049,1065,984,2049,2,1,Attchd,1997.0,Unf,2.0
2852,60,RL,11250,CollgCr,7,5,1998,1939,1070,869,1939,2,1,Attchd,1998.0,RFn,3.0
2853,60,RL,11250,CollgCr,7,5,1995,1995,950,1045,1995,2,1,Attchd,1995.0,RFn,2.0
2854,120,RM,4435,CollgCr,6,5,2003,848,848,0,848,1,0,Attchd,2003.0,Fin,2.0
2855,20,RL,8810,CollgCr,7,5,2003,1390,1390,0,1390,2,0,Attchd,2003.0,RFn,2.0
2856,60,RL,8581,CollgCr,7,5,2006,1737,851,886,1737,2,1,Attchd,2006.0,RFn,2.0
2857,60,RL,8400,CollgCr,7,5,2005,1611,784,827,1611,2,1,Attchd,2005.0,RFn,2.0
2858,20,RL,8772,CollgCr,7,5,2005,1336,1336,0,1336,2,0,Attchd,2005.0,Unf,2.0
2859,70,RL,8777,Edwards,4,6,1910,1436,760,676,1436,2,0,Attchd,1950.0,Unf,2.0
2860,90,RL,7840,Edwards,6,5,1975,1012,1012,0,1012,2,0,,,,0.0
2861,20,RL,16133,Edwards,5,4,1969,1176,1176,0,1176,1,0,Attchd,1969.0,Unf,1.0
2862,60,RL,7162,Edwards,7,5,2003,1724,806,918,1724,2,1,BuiltIn,2003.0,Fin,2.0
2863,20,RL,8050,Edwards,6,5,2002,914,914,0,914,1,0,,,,0.0
2864,60,RL,11060,Edwards,7,5,2003,2314,1164,1150,2314,2,1,BuiltIn,2003.0,Fin,2.0
2865,180,RM,3675,Edwards,6,5,2005,1072,1072,0,1072,1,0,Basment,2005.0,Fin,2.0
2866,160,RM,2522,Edwards,7,5,2004,1709,970,739,1709,2,0,Detchd,2004.0,Unf,2.0
2867,50,RL,6956,Edwards,4,7,1948,936,624,312,936,1,0,Attchd,1948.0,Unf,1.0
2868,50,RL,7822,Edwards,6,3,1915,1338,846,492,1338,2,0,Detchd,1974.0,Unf,2.0
2869,50,RL,8707,Edwards,4,5,1924,1669,1093,576,1669,1,1,Attchd,1924.0,Unf,1.0
2870,20,RL,16012,Edwards,4,4,1954,1482,1482,0,1482,2,0,2Types,1956.0,Unf,2.0
2871,50,RL,8248,Edwards,4,4,1922,1414,964,0,1414,1,0,,,,0.0
2872,30,RL,8088,Edwards,2,3,1922,498,498,0,498,1,0,Detchd,1922.0,Unf,1.0
2873,50,RL,11388,Edwards,4,7,1910,1273,1055,218,1273,1,0,Detchd,1910.0,Unf,1.0
2874,50,RL,10890,SWISU,5,5,1938,1551,1058,493,1551,2,0,Detchd,1938.0,Unf,1.0
2875,190,RH,6430,SWISU,6,6,1945,1340,816,524,1340,1,0,Attchd,1945.0,Unf,1.0
2876,70,RL,7000,SWISU,7,8,1926,1479,743,736,1479,1,0,Detchd,1926.0,Unf,1.0
2877,70,RL,4899,SWISU,6,8,1920,1510,755,755,1510,1,0,Detchd,1920.0,Unf,1.0
2878,70,RL,9399,Crawfor,7,8,1919,1636,818,818,1636,1,1,Detchd,1919.0,Unf,1.0
2879,50,RL,10164,SWISU,5,5,1939,1465,992,473,1465,2,0,Detchd,1939.0,Unf,1.0
2880,50,RL,6191,SWISU,5,4,1941,1288,824,464,1288,1,0,Detchd,1941.0,Unf,1.0
2881,50,RL,21780,Crawfor,6,5,1920,1550,940,610,1550,1,1,Detchd,1937.0,Unf,1.0
2882,50,RL,12400,Crawfor,5,6,1940,1717,1125,592,1717,1,1,Attchd,1940.0,Unf,1.0
2883,50,RL,8170,Crawfor,7,7,1929,1671,1122,549,1671,2,0,Detchd,1963.0,Unf,2.0
2884,70,RL,12320,Crawfor,7,7,1932,1609,959,650,1609,1,1,2Types,1963.0,Unf,3.0
2885,70,RL,14210,Crawfor,6,7,1930,1801,1104,697,1801,1,1,Attchd,1930.0,Unf,2.0
2886,60,RL,15600,Crawfor,5,7,1950,2315,1278,1037,2315,2,0,Attchd,1950.0,Fin,1.0
2887,30,RM,7288,IDOTRR,5,6,1942,976,976,0,976,1,0,Detchd,1942.0,Unf,1.0
2888,50,RM,7000,IDOTRR,6,7,1926,1285,861,424,1285,1,0,Detchd,1950.0,Fin,2.0
2889,30,RM,8534,IDOTRR,4,4,1925,672,672,0,672,1,0,,,,0.0
2890,30,RM,7030,IDOTRR,4,6,1925,641,641,0,641,1,0,Detchd,1925.0,Unf,1.0
2891,50,RM,9060,IDOTRR,6,5,1957,1638,967,671,1638,2,0,Detchd,1957.0,Unf,1.0
2892,30,C (all),12366,IDOTRR,3,5,1945,729,729,0,729,1,0,,,,0.0
2893,190,C (all),9000,IDOTRR,5,6,1951,1396,1060,336,1396,2,0,,,,0.0
2894,50,C (all),8520,IDOTRR,3,5,1916,936,576,360,936,1,0,,,,0.0
2895,120,RM,5748,Crawfor,8,5,2005,1778,1778,0,1778,2,0,Attchd,2005.0,Fin,2.0
2896,120,RM,3842,Crawfor,8,5,2004,1646,1646,0,1646,2,0,Attchd,2004.0,Fin,2.0
2897,20,RL,23580,Mitchel,6,6,1979,1625,1625,0,1625,2,0,Attchd,1979.0,Fin,2.0
2898,90,RL,8385,Mitchel,6,5,1978,1664,1664,0,1664,2,0,2Types,1978.0,Unf,2.0
2899,20,RL,9116,Mitchel,8,5,2001,1491,1491,0,1491,2,0,Attchd,2001.0,RFn,2.0
2900,80,RL,11080,Mitchel,6,6,1975,1210,1210,0,1210,2,0,Attchd,1975.0,Unf,2.0
2901,20,RL,50102,Timber,6,5,1958,1650,1650,0,1650,1,0,Attchd,1958.0,Unf,2.0
2902,20,RL,8098,Timber,6,5,2000,1403,1403,0,1403,2,0,Attchd,2000.0,Unf,2.0
2903,20,RL,13618,Timber,8,5,2005,1960,1960,0,1960,2,0,Attchd,2005.0,Fin,3.0
2904,20,RL,11577,Timber,9,5,2005,1838,1838,0,1838,2,0,Attchd,2005.0,Fin,3.0
2905,20,,31250,Mitchel,1,3,1951,1600,1600,0,1600,1,1,Attchd,1951.0,Unf,1.0
2906,90,RM,7020,Mitchel,7,5,1997,1368,1368,0,1368,2,0,Attchd,1997.0,Fin,4.0
2907,160,RM,2665,MeadowV,5,6,1977,1304,616,688,1304,1,1,BuiltIn,1977.0,RFn,1.0
2908,20,RL,10172,Mitchel,5,7,1968,874,874,0,874,1,0,Attchd,1968.0,RFn,1.0
2909,90,RL,11836,Mitchel,5,5,1970,1652,1652,0,1652,2,0,2Types,1970.0,Unf,3.0
2910,180,RM,1470,MeadowV,4,6,1970,630,630,0,630,1,0,,,,0.0
2911,160,RM,1484,MeadowV,4,4,1972,1092,546,546,1092,1,1,Attchd,1972.0,Unf,1.0
2912,20,RL,13384,Mitchel,5,5,1969,1360,1360,0,1360,1,0,Attchd,1969.0,RFn,1.0
2913,160,RM,1533,MeadowV,4,5,1970,1092,546,546,1092,1,1,CarPort,1970.0,Unf,1.0
2914,160,RM,1526,MeadowV,4,5,1970,1092,546,546,1092,1,1,,,,0.0
2915,160,RM,1936,MeadowV,4,7,1970,1092,546,546,1092,1,1,,,,0.0
2916,160,RM,1894,MeadowV,4,5,1970,1092,546,546,1092,1,1,CarPort,1970.0,Unf,1.0
2917,20,RL,20000,Mitchel,5,7,1960,1224,1224,0,1224,1,0,Detchd,1960.0,Unf,2.0
2918,85,RL,10441,Mitchel,5,5,1992,970,970,0,970,1,0,,,,0.0
2919,60,RL,9627,Mitchel,7,5,1993,2000,996,1004,2000,2,1,Attchd,1993.0,Fin,3.0
