Season,T1TeamID,T1Score,T2TeamID,T2Score,Result,T1Seed,T2Seed,SeedDiff
1985,1116,63,1234,54,1,9,8,1
1985,1120,59,1345,58,1,11,6,5
1985,1207,68,1250,43,1,1,16,-15
1985,1229,58,1425,55,1,9,8,1
1985,1242,49,1325,38,1,3,14,-11
1985,1246,66,1449,58,1,12,5,7
1985,1256,78,1338,54,1,5,12,-7
1985,1260,59,1233,58,1,4,13,-9
1985,1314,76,1292,57,1,2,15,-13
1985,1323,79,1333,70,1,7,10,-3
1985,1326,75,1235,64,1,4,13,-9
1985,1328,96,1299,83,1,1,16,-15
1985,1374,85,1330,68,1,5,12,-7
1985,1385,83,1380,59,1,1,16,-15
1985,1396,60,1439,57,1,8,9,-1
1985,1424,85,1361,80,1,4,13,-9
1985,1104,50,1112,41,1,7,10,-3
1985,1130,55,1403,53,1,11,6,5
1985,1181,75,1337,62,1,3,14,-11
1985,1208,67,1455,59,1,6,11,-5
1985,1210,65,1273,58,1,2,15,-13
1985,1228,76,1318,57,1,3,14,-11
1985,1268,69,1275,68,1,5,12,-7
1985,1272,67,1335,55,1,2,15,-13
1985,1276,59,1192,55,1,1,16,-15
1985,1298,78,1261,55,1,13,4,9
1985,1301,65,1305,56,1,3,14,-11
1985,1393,70,1177,65,1,7,10,-3
1985,1412,70,1277,68,1,7,10,-3
1985,1431,79,1409,75,1,11,6,5
1985,1433,81,1267,65,1,2,15,-13
1985,1437,51,1173,49,1,8,9,-1
1985,1120,66,1242,64,1,11,3,8
1985,1207,63,1396,46,1,1,8,-7
1985,1246,64,1424,61,1,12,4,8
1985,1256,79,1326,67,1,5,4,1
1985,1260,70,1374,57,1,4,5,-1
1985,1314,60,1323,58,1,2,7,-5
1985,1328,75,1229,69,1,1,9,-8
1985,1385,68,1116,65,1,1,9,-8
1985,1104,63,1433,59,1,7,2,5
1985,1130,74,1181,73,1,11,3,8
1985,1210,70,1393,53,1,2,7,-5
1985,1228,74,1208,58,1,3,6,-3
1985,1268,64,1298,59,1,5,13,-8
1985,1272,67,1412,66,1,2,7,-5
1985,1301,86,1431,73,1,3,11,-8
1985,1437,59,1276,55,1,8,1,7
1985,1207,65,1260,53,1,1,4,-3
1985,1210,61,1228,53,1,2,3,-1
1985,1272,59,1130,57,1,2,11,-9
1985,1328,86,1256,84,1,1,5,-4
1985,1301,61,1104,55,1,3,7,-4
1985,1314,62,1120,56,1,2,11,-9
1985,1385,86,1246,70,1,1,12,-11
1985,1437,46,1268,43,1,8,5,3
1985,1207,60,1210,54,1,1,2,-1
1985,1272,63,1328,61,1,2,1,1
1985,1385,69,1301,60,1,1,3,-2
1985,1437,56,1314,44,1,8,2,6
1985,1207,77,1385,59,1,1,1,0
1985,1437,52,1272,45,1,8,2,6
1985,1437,66,1207,64,1,8,1,7
1986,1133,83,1431,65,1,7,10,-3
1986,1177,72,1438,68,1,12,5,7
1986,1181,85,1290,78,1,1,16,-15
1986,1207,70,1403,64,1,4,13,-9
1986,1210,68,1265,53,1,2,15,-13
1986,1242,71,1299,46,1,1,16,-15
1986,1257,93,1180,73,1,2,15,-13
1986,1261,94,1345,87,1,11,6,5
1986,1272,95,1123,63,1,3,14,-11
1986,1277,72,1449,70,1,5,12,-7
1986,1314,84,1428,72,1,3,14,-11
1986,1328,80,1318,74,1,4,13,-9
1986,1330,72,1452,64,1,8,9,-1
1986,1396,61,1239,50,1,9,8,1
1986,1412,66,1281,64,1,6,11,-5
1986,1437,71,1439,62,1,10,7,3
1986,1104,97,1462,80,1,5,12,-7
1986,1114,90,1323,83,1,14,3,11
1986,1120,73,1112,63,1,8,9,-1
1986,1156,83,1231,79,1,14,3,11
1986,1228,75,1193,51,1,4,13,-9
1986,1235,81,1275,79,1,7,10,-3
1986,1246,75,1172,55,1,1,16,-15
1986,1268,69,1337,64,1,5,12,-7
1986,1276,70,1103,64,1,2,15,-13
1986,1298,87,1409,68,1,7,10,-3
1986,1301,66,1234,64,1,6,11,-5
1986,1385,83,1286,74,1,1,16,-15
1986,1386,60,1350,59,1,6,11,-5
1986,1393,101,1135,52,1,2,15,-13
1986,1424,74,1419,51,1,4,13,-9
1986,1443,67,1304,59,1,8,9,-1
1986,1177,74,1328,69,1,12,4,8
1986,1181,89,1330,61,1,1,8,-7
1986,1210,66,1437,61,1,2,10,-8
1986,1242,65,1396,43,1,1,9,-8
1986,1257,82,1133,68,1,2,7,-5
1986,1261,83,1272,81,1,11,3,8
1986,1277,80,1207,68,1,5,4,1
1986,1314,77,1412,59,1,3,6,-3
1986,1104,58,1228,56,1,5,4,1
1986,1120,81,1385,65,1,8,1,7
1986,1156,75,1386,69,1,14,6,8
1986,1235,72,1276,69,1,7,2,5
1986,1246,71,1443,64,1,1,8,-7
1986,1298,97,1393,85,1,7,2,5
1986,1301,80,1114,66,1,6,14,-8
1986,1424,70,1268,64,1,4,5,-1
1986,1120,70,1424,63,1,8,4,4
1986,1246,68,1104,63,1,1,5,-4
1986,1257,94,1314,79,1,2,3,-1
1986,1261,70,1210,64,1,11,2,9
1986,1181,74,1177,67,1,1,12,-11
1986,1242,96,1277,86,1,1,5,-4
1986,1298,71,1156,70,1,7,14,-7
1986,1301,70,1235,66,1,6,7,-1
1986,1257,84,1120,76,1,2,8,-6
1986,1261,59,1246,57,1,11,1,10
1986,1181,71,1298,50,1,1,7,-6
1986,1242,75,1301,67,1,1,6,-5
1986,1181,71,1242,67,1,1,1,0
1986,1257,88,1261,77,1,2,11,-9
1986,1257,72,1181,69,1,2,1,1
1987,1104,88,1299,71,1,2,15,-13
1987,1120,62,1360,61,1,8,9,-1
1987,1122,68,1228,67,1,14,3,11
1987,1181,58,1401,51,1,5,12,-7
1987,1231,92,1193,58,1,1,16,-15
1987,1243,82,1208,79,1,9,8,1
1987,1276,97,1298,82,1,9,8,1
1987,1309,83,1140,79,1,7,10,-3
1987,1314,113,1335,82,1,1,16,-15
1987,1323,84,1292,71,1,5,12,-7
1987,1344,90,1412,68,1,6,11,-5
1987,1395,76,1267,60,1,4,13,-9
1987,1417,92,1141,73,1,4,13,-9
1987,1424,95,1226,70,1,1,16,-15
1987,1461,64,1438,60,1,12,5,7
1987,1462,70,1281,69,1,13,4,9
1987,1177,76,1256,62,1,3,14,-11
1987,1196,82,1301,70,1,6,11,-5
1987,1207,75,1137,53,1,1,16,-15
1987,1234,99,1365,76,1,2,15,-13
1987,1242,66,1222,55,1,5,12,-7
1987,1261,85,1210,79,1,10,7,3
1987,1283,65,1155,60,1,13,4,9
1987,1326,91,1246,77,1,9,8,1
1987,1328,74,1409,69,1,6,11,-5
1987,1338,93,1265,68,1,3,14,-11
1987,1345,104,1318,95,1,3,14,-11
1987,1385,57,1455,55,1,6,11,-5
1987,1393,79,1204,73,1,2,15,-13
1987,1396,75,1380,56,1,2,15,-13
1987,1431,98,1112,91,1,7,10,-3
1987,1443,64,1452,62,1,10,7,3
1987,1104,101,1309,76,1,2,7,-5
1987,1181,65,1462,60,1,5,13,-8
1987,1231,107,1120,90,1,1,8,-7
1987,1314,109,1276,97,1,1,9,-8
1987,1323,58,1395,57,1,5,4,1
1987,1344,90,1122,87,1,6,14,-8
1987,1424,80,1243,61,1,1,9,-8
1987,1461,78,1417,68,1,12,4,8
1987,1177,83,1385,75,1,3,6,-3
1987,1196,85,1345,66,1,6,3,3
1987,1207,82,1326,79,1,1,9,-8
1987,1234,84,1431,82,1,2,7,-5
1987,1242,67,1283,63,1,5,13,-8
1987,1261,72,1396,62,1,10,2,8
1987,1328,96,1338,93,1,6,3,3
1987,1393,104,1443,86,1,2,10,-8
1987,1207,70,1242,57,1,1,5,-4
1987,1314,74,1323,68,1,1,5,-4
1987,1344,103,1104,82,1,6,2,4
1987,1393,87,1196,81,1,2,6,-4
1987,1231,88,1181,82,1,1,5,-4
1987,1234,93,1328,91,1,2,6,-4
1987,1261,63,1177,58,1,10,3,7
1987,1424,92,1461,78,1,1,12,-11
1987,1344,88,1207,73,1,6,1,5
1987,1393,79,1314,75,1,2,1,1
1987,1231,77,1261,76,1,1,10,-9
1987,1424,84,1234,81,1,1,2,-1
1987,1231,97,1424,93,1,1,1,0
1987,1393,77,1344,63,1,2,6,-4
1987,1231,74,1393,73,1,1,2,-1
1988,1120,90,1133,86,1,8,9,-1
1988,1140,98,1150,92,1,4,13,-9
1988,1177,83,1455,62,1,5,12,-7
1988,1181,85,1131,69,1,2,15,-13
1988,1196,62,1385,59,1,6,11,-5
1988,1243,66,1247,53,1,4,13,-9
1988,1257,70,1333,61,1,5,12,-7
1988,1258,119,1461,115,1,10,7,3
1988,1272,75,1124,60,1,9,8,1
1988,1276,63,1129,58,1,3,14,-11
1988,1314,83,1317,65,1,2,15,-13
1988,1328,94,1151,66,1,1,16,-15
1988,1345,94,1192,79,1,1,16,-15
1988,1348,87,1281,80,1,11,6,5
1988,1374,83,1323,75,1,7,10,-3
1988,1393,69,1299,55,1,3,14,-11
1988,1112,90,1165,50,1,1,16,-15
1988,1207,66,1261,63,1,8,9,-1
1988,1210,90,1235,78,1,5,12,-7
1988,1228,81,1427,72,1,3,14,-11
1988,1234,102,1199,98,1,5,12,-7
1988,1242,85,1462,72,1,6,11,-5
1988,1246,99,1380,84,1,2,15,-13
1988,1268,92,1364,82,1,7,10,-3
1988,1293,78,1301,75,1,14,3,11
1988,1338,108,1185,90,1,2,15,-13
1988,1350,72,1231,69,1,13,4,9
1988,1371,80,1431,64,1,8,9,-1
1988,1396,87,1250,73,1,1,16,-15
1988,1424,54,1283,50,1,4,13,-9
1988,1435,80,1429,77,1,7,10,-3
1988,1437,82,1116,74,1,6,11,-5
1988,1181,94,1374,79,1,2,7,-5
1988,1243,66,1177,58,1,4,5,-1
1988,1257,97,1140,76,1,5,4,1
1988,1276,108,1196,85,1,3,6,-3
1988,1314,123,1258,97,1,2,10,-8
1988,1328,107,1120,87,1,1,8,-7
1988,1345,100,1272,73,1,1,9,-8
1988,1348,97,1393,94,1,11,3,8
1988,1112,84,1371,55,1,1,8,-7
1988,1234,104,1424,86,1,5,4,1
1988,1242,61,1293,58,1,6,14,-8
1988,1246,90,1268,81,1,2,7,-5
1988,1350,59,1210,55,1,13,5,8
1988,1396,74,1207,53,1,1,8,-7
1988,1435,80,1338,74,1,7,2,5
1988,1437,66,1228,63,1,6,3,3
1988,1181,73,1348,72,1,2,11,-9
1988,1328,108,1257,98,1,1,5,-4
1988,1396,69,1350,47,1,1,13,-12
1988,1437,80,1246,74,1,6,2,4
1988,1112,99,1234,79,1,1,5,-4
1988,1242,77,1435,64,1,6,7,-1
1988,1243,73,1345,70,1,4,1,3
1988,1314,78,1276,69,1,2,3,-1
1988,1181,63,1396,53,1,2,1,1
1988,1328,78,1437,59,1,1,6,-5
1988,1112,70,1314,52,1,1,2,-1
1988,1242,71,1243,58,1,6,4,2
1988,1242,66,1181,59,1,6,2,4
1988,1328,86,1112,78,1,1,1,0
1988,1242,83,1328,79,1,6,1,5
1989,1112,94,1352,60,1,1,16,-15
1989,1116,120,1258,101,1,5,12,-7
1989,1123,68,1338,64,1,9,8,1
1989,1155,83,1388,70,1,9,8,1
1989,1177,66,1272,63,1,12,5,7
1989,1181,90,1354,69,1,2,15,-13
1989,1228,77,1270,71,1,1,16,-15
1989,1256,83,1247,74,1,9,8,1
1989,1257,76,1114,71,1,4,13,-9
1989,1278,86,1243,75,1,11,6,5
1989,1292,97,1199,83,1,13,4,9
1989,1328,72,1190,71,1,1,16,-15
1989,1373,80,1390,78,1,14,3,11
1989,1424,68,1225,56,1,4,13,-9
1989,1438,100,1344,97,1,5,12,-7
1989,1452,84,1397,68,1,7,10,-3
1989,1161,68,1196,46,1,10,7,3
1989,1191,94,1333,90,1,11,6,5
1989,1207,50,1343,49,1,1,16,-15
1989,1231,99,1206,85,1,2,15,-13
1989,1234,87,1353,73,1,4,13,-9
1989,1276,92,1462,87,1,3,14,-11
1989,1281,85,1166,69,1,3,14,-11
1989,1301,81,1376,66,1,5,12,-7
1989,1314,93,1380,79,1,2,15,-13
1989,1323,81,1435,65,1,9,8,1
1989,1371,60,1283,51,1,3,14,-11
1989,1375,86,1104,84,1,11,6,5
1989,1393,104,1137,81,1,2,15,-13
1989,1400,76,1210,70,1,11,6,5
1989,1417,84,1235,74,1,7,10,-3
1989,1431,85,1261,74,1,7,10,-3
1989,1112,94,1155,68,1,1,9,-8
1989,1181,70,1452,63,1,2,7,-5
1989,1228,72,1123,60,1,1,9,-8
1989,1257,93,1116,84,1,4,5,-1
1989,1278,80,1373,67,1,11,14,-3
1989,1328,124,1256,81,1,1,9,-8
1989,1424,85,1177,70,1,4,12,-8
1989,1438,104,1292,88,1,5,13,-8
1989,1207,81,1323,74,1,1,9,-8
1989,1231,92,1431,69,1,2,7,-5
1989,1276,91,1375,82,1,3,11,-8
1989,1281,108,1400,89,1,3,11,-8
1989,1301,102,1234,96,1,5,4,1
1989,1314,88,1417,81,1,2,7,-5
1989,1371,87,1191,73,1,3,11,-8
1989,1393,65,1161,50,1,2,10,-8
1989,1276,92,1314,87,1,3,2,1
1989,1371,78,1231,65,1,3,2,1
1989,1424,68,1112,67,1,4,1,3
1989,1438,86,1328,80,1,5,1,4
1989,1181,87,1278,70,1,2,11,-9
1989,1207,69,1301,61,1,1,5,-4
1989,1228,83,1257,69,1,1,4,-3
1989,1393,83,1281,80,1,2,3,-1
1989,1276,102,1438,65,1,3,5,-2
1989,1371,84,1424,61,1,3,4,-1
1989,1181,85,1207,77,1,2,1,1
1989,1228,89,1393,86,1,1,2,-1
1989,1276,83,1228,81,1,3,1,2
1989,1371,95,1181,78,1,3,2,1
1989,1276,80,1371,79,1,3,3,0
1990,1116,68,1343,64,1,4,13,-9
1990,1123,54,1333,53,1,12,5,7
1990,1143,65,1231,63,1,9,8,1
1990,1155,49,1140,47,1,5,12,-7
1990,1163,76,1131,52,1,1,16,-15
1990,1173,88,1228,86,1,12,5,7
1990,1210,99,1190,83,1,4,13,-9
1990,1247,79,1379,63,1,4,13,-9
1990,1257,78,1225,59,1,4,13,-9
1990,1261,70,1437,63,1,5,12,-7
1990,1277,75,1293,71,1,1,16,-15
1990,1314,83,1283,70,1,8,9,-1
1990,1326,84,1344,83,1,8,9,-1
1990,1328,77,1406,68,1,1,16,-15
1990,1364,70,1222,66,1,9,8,1
1990,1424,102,1114,72,1,1,16,-15
1990,1104,71,1161,54,1,7,10,-3
1990,1112,79,1378,67,1,2,15,-13
1990,1181,81,1350,46,1,3,14,-11
1990,1207,70,1411,52,1,3,14,-11
1990,1242,79,1352,71,1,2,15,-13
1990,1258,111,1308,92,1,11,6,5
1990,1276,76,1229,70,1,3,14,-11
1990,1278,64,1431,61,1,6,11,-5
1990,1320,74,1281,71,1,14,3,11
1990,1345,75,1419,63,1,2,15,-13
1990,1385,81,1396,65,1,6,11,-5
1990,1393,70,1164,48,1,2,15,-13
1990,1400,100,1208,88,1,10,7,3
1990,1417,68,1412,56,1,7,10,-3
1990,1438,75,1323,67,1,7,10,-3
1990,1462,87,1243,79,1,6,11,-5
1990,1116,86,1173,84,1,4,12,-8
1990,1123,62,1257,60,1,12,4,8
1990,1155,79,1247,75,1,5,4,1
1990,1163,74,1143,54,1,1,9,-8
1990,1210,94,1261,91,1,4,5,-1
1990,1277,62,1364,58,1,1,9,-8
1990,1314,79,1328,77,1,8,1,7
1990,1424,76,1326,65,1,1,8,-7
1990,1104,77,1112,55,1,7,2,5
1990,1181,76,1385,72,1,3,6,-3
1990,1258,149,1276,115,1,11,3,8
1990,1278,81,1320,78,1,6,14,-8
1990,1393,63,1438,61,1,2,7,-5
1990,1400,73,1345,72,1,10,2,8
1990,1417,71,1242,70,1,7,2,5
1990,1462,74,1207,71,1,6,3,3
1990,1116,96,1314,73,1,4,8,-4
1990,1163,71,1155,70,1,1,5,-4
1990,1181,90,1417,81,1,3,7,-4
1990,1400,102,1462,89,1,10,6,4
1990,1210,81,1277,80,1,4,1,3
1990,1258,62,1104,60,1,11,7,4
1990,1278,82,1393,75,1,6,2,4
1990,1424,69,1123,67,1,1,12,-11
1990,1116,88,1400,85,1,4,10,-6
1990,1181,79,1163,78,1,3,1,2
1990,1210,93,1278,91,1,4,6,-2
1990,1424,131,1258,101,1,1,11,-10
1990,1181,97,1116,83,1,3,4,-1
1990,1424,90,1210,81,1,1,4,-3
1990,1424,103,1181,73,1,1,3,-2
1991,1112,93,1384,80,1,2,15,-13
1991,1140,61,1438,48,1,10,7,3
1991,1163,79,1261,62,1,11,6,5
1991,1166,64,1308,56,1,11,6,5
1991,1181,102,1419,73,1,2,15,-13
1991,1199,75,1425,72,1,7,10,-3
1991,1231,79,1157,69,1,2,15,-13
1991,1234,76,1190,73,1,7,10,-3
1991,1242,55,1309,49,1,3,14,-11
1991,1301,114,1379,85,1,6,11,-5
1991,1329,67,1307,54,1,3,14,-11
1991,1338,76,1208,68,1,6,11,-5
1991,1350,73,1393,69,1,15,2,13
1991,1371,71,1337,51,1,3,14,-11
1991,1396,80,1345,63,1,10,7,3
1991,1462,89,1304,84,1,14,3,11
1991,1104,89,1293,79,1,4,13,-9
1991,1113,79,1353,76,1,8,9,-1
1991,1116,117,1209,76,1,1,16,-15
1991,1185,76,1280,56,1,12,5,7
1991,1207,70,1435,60,1,8,9,-1
1991,1210,87,1177,70,1,8,9,-1
1991,1277,60,1453,58,1,5,12,-7
1991,1314,101,1318,66,1,1,16,-15
1991,1326,97,1406,86,1,1,16,-15
1991,1336,74,1417,69,1,13,4,9
1991,1385,75,1296,68,1,4,13,-9
1991,1400,73,1389,65,1,5,12,-7
1991,1424,99,1285,65,1,1,16,-15
1991,1428,82,1375,72,1,4,13,-9
1991,1437,50,1343,48,1,9,8,1
1991,1448,71,1256,65,1,5,12,-7
1991,1112,76,1140,61,1,2,10,-8
1991,1163,66,1462,50,1,11,14,-3
1991,1181,85,1234,70,1,2,7,-5
1991,1231,82,1199,60,1,2,7,-5
1991,1242,77,1338,66,1,3,6,-3
1991,1329,73,1301,64,1,3,6,-3
1991,1371,81,1166,69,1,3,11,-8
1991,1396,77,1350,64,1,10,15,-5
1991,1104,96,1448,88,1,4,5,-1
1991,1116,97,1113,90,1,1,8,-7
1991,1185,71,1336,68,1,12,13,-1
1991,1314,84,1437,69,1,1,9,-8
1991,1326,65,1210,61,1,1,8,-7
1991,1385,84,1400,76,1,4,5,-1
1991,1424,62,1207,54,1,1,8,-7
1991,1428,85,1277,84,1,4,5,-1
1991,1116,93,1104,70,1,1,4,-3
1991,1242,83,1231,65,1,3,2,1
1991,1371,81,1112,77,1,3,2,1
1991,1424,83,1428,66,1,1,4,-3
1991,1181,81,1163,67,1,2,11,-9
1991,1314,93,1185,67,1,1,12,-11
1991,1385,91,1326,74,1,4,1,3
1991,1396,72,1329,63,1,10,3,7
1991,1242,93,1116,81,1,3,1,2
1991,1424,77,1371,65,1,1,3,-2
1991,1181,78,1385,61,1,2,4,-2
1991,1314,75,1396,72,1,1,10,-9
1991,1181,79,1424,77,1,2,1,1
1991,1242,79,1314,73,1,3,1,2
1991,1181,72,1242,65,1,2,3,-1
1992,1104,80,1390,75,1,5,12,-7
1992,1116,80,1293,69,1,3,14,-11
1992,1163,86,1304,65,1,9,8,1
1992,1181,82,1144,56,1,1,16,-15
1992,1199,78,1285,68,1,3,14,-11
1992,1207,75,1378,60,1,6,11,-5
1992,1210,65,1222,60,1,7,10,-3
1992,1231,94,1183,55,1,2,15,-13
1992,1234,98,1400,92,1,9,8,1
1992,1261,94,1140,83,1,7,10,-3
1992,1272,80,1337,70,1,6,11,-5
1992,1281,89,1452,78,1,5,12,-7
1992,1314,68,1275,63,1,4,13,-9
1992,1326,83,1290,56,1,1,16,-15
1992,1371,78,1247,76,1,4,13,-9
1992,1425,84,1419,54,1,2,15,-13
1992,1153,85,1174,47,1,4,13,-9
1992,1190,87,1112,80,1,14,3,11
1992,1235,76,1150,74,1,10,7,3
1992,1242,100,1224,67,1,1,16,-15
1992,1246,88,1330,69,1,2,15,-13
1992,1257,81,1448,58,1,8,9,-1
1992,1269,85,1200,58,1,3,14,-11
1992,1276,73,1396,66,1,6,11,-5
1992,1277,61,1283,54,1,5,12,-7
1992,1308,81,1177,73,1,12,5,7
1992,1329,100,1204,73,1,2,15,-13
1992,1393,51,1343,43,1,6,11,-5
1992,1408,61,1385,57,1,10,7,3
1992,1417,73,1352,53,1,1,16,-15
1992,1418,87,1328,83,1,13,4,9
1992,1431,55,1191,50,1,9,8,1
1992,1181,75,1234,62,1,1,9,-8
1992,1199,78,1207,68,1,3,6,-3
1992,1210,79,1425,78,1,7,2,5
1992,1231,89,1261,79,1,2,7,-5
1992,1272,82,1116,80,1,6,3,3
1992,1314,64,1104,55,1,4,5,-1
1992,1326,78,1163,55,1,1,9,-8
1992,1371,88,1281,71,1,4,5,-1
1992,1153,77,1277,65,1,4,5,-1
1992,1246,106,1235,98,1,2,10,-8
1992,1269,77,1393,71,1,3,6,-3
1992,1276,102,1190,90,1,6,14,-8
1992,1308,81,1418,73,1,12,13,-1
1992,1329,87,1408,71,1,2,10,-8
1992,1417,85,1257,69,1,1,8,-7
1992,1431,66,1242,60,1,9,1,8
1992,1181,81,1371,69,1,1,4,-3
1992,1231,85,1199,74,1,2,3,-1
1992,1246,87,1269,77,1,2,3,-1
1992,1417,85,1308,78,1,1,12,-11
1992,1153,69,1431,67,1,4,9,-5
1992,1272,83,1210,79,1,6,7,-1
1992,1276,75,1329,72,1,6,2,4
1992,1326,80,1314,73,1,1,4,-3
1992,1181,104,1246,103,1,1,2,-1
1992,1231,106,1417,79,1,2,1,1
1992,1153,88,1272,57,1,4,6,-2
1992,1276,75,1326,71,1,6,1,5
1992,1181,81,1231,78,1,1,2,-1
1992,1276,76,1153,72,1,6,4,2
1992,1181,71,1276,51,1,1,6,-5
1993,1116,94,1221,64,1,4,13,-9
1993,1140,80,1374,71,1,7,10,-3
1993,1143,66,1261,64,1,6,11,-5
1993,1181,105,1356,70,1,3,14,-11
1993,1199,82,1191,70,1,3,14,-11
1993,1228,75,1253,72,1,6,11,-5
1993,1242,94,1123,72,1,2,15,-13
1993,1314,85,1187,65,1,1,16,-15
1993,1348,74,1345,68,1,8,9,-1
1993,1365,64,1112,61,1,15,2,13
1993,1371,81,1398,59,1,2,15,-13
1993,1385,85,1403,67,1,5,12,-7
1993,1396,75,1281,61,1,7,10,-3
1993,1408,55,1243,53,1,11,6,5
1993,1435,92,1129,72,1,3,14,-11
1993,1443,55,1272,52,1,7,10,-3
1993,1153,93,1164,66,1,2,15,-13
1993,1203,82,1307,68,1,12,5,7
1993,1231,97,1460,54,1,1,16,-15
1993,1234,82,1419,69,1,4,13,-9
1993,1246,96,1351,52,1,1,16,-15
1993,1257,76,1174,70,1,4,13,-9
1993,1269,54,1335,50,1,3,14,-11
1993,1276,84,1157,52,1,1,16,-15
1993,1308,93,1304,79,1,7,10,-3
1993,1329,74,1266,62,1,5,12,-7
1993,1380,93,1210,78,1,13,4,9
1993,1417,81,1235,70,1,9,8,1
1993,1428,86,1338,65,1,8,9,-1
1993,1438,78,1264,66,1,6,11,-5
1993,1448,81,1151,58,1,5,12,-7
1993,1462,73,1309,55,1,9,8,1
1993,1116,80,1385,74,1,4,5,-1
1993,1143,82,1181,77,1,6,3,3
1993,1199,94,1408,63,1,3,11,-8
1993,1242,90,1140,76,1,2,7,-5
1993,1314,112,1348,67,1,1,8,-7
1993,1396,68,1365,57,1,7,15,-8
1993,1435,85,1228,68,1,3,6,-3
1993,1443,72,1371,68,1,7,2,5
1993,1153,92,1308,55,1,2,7,-5
1993,1203,90,1380,80,1,12,13,-1
1993,1231,73,1462,70,1,1,9,-8
1993,1246,83,1428,62,1,1,8,-7
1993,1257,78,1329,63,1,4,5,-1
1993,1276,86,1417,84,1,1,9,-8
1993,1438,71,1269,56,1,6,3,3
1993,1448,84,1234,78,1,5,4,1
1993,1199,81,1443,78,1,3,7,-4
1993,1231,82,1257,69,1,1,4,-3
1993,1242,93,1143,76,1,2,6,-4
1993,1246,103,1448,69,1,1,5,-4
1993,1153,71,1438,54,1,2,6,-4
1993,1276,72,1203,64,1,1,12,-11
1993,1314,80,1116,74,1,1,4,-3
1993,1396,67,1435,59,1,7,3,4
1993,1242,83,1231,77,1,2,1,1
1993,1246,106,1199,81,1,1,3,-2
1993,1276,77,1396,72,1,1,7,-6
1993,1314,75,1153,68,1,1,2,-1
1993,1276,81,1246,78,1,1,1,0
1993,1314,78,1242,68,1,1,2,-1
1993,1314,77,1276,71,1,1,1,0
1994,1104,76,1344,70,1,9,8,1
1994,1163,64,1351,46,1,2,15,-13
1994,1196,64,1241,62,1,3,14,-11
1994,1203,51,1412,46,1,10,7,3
1994,1242,102,1151,73,1,4,13,-9
1994,1268,74,1387,66,1,10,7,3
1994,1269,78,1402,60,1,2,15,-13
1994,1276,78,1337,74,1,3,14,-11
1994,1281,76,1298,53,1,1,16,-15
1994,1335,90,1304,80,1,11,6,5
1994,1345,98,1416,67,1,1,16,-15
1994,1393,92,1218,78,1,4,13,-9
1994,1400,91,1443,77,1,6,11,-5
1994,1448,68,1158,58,1,5,12,-7
1994,1453,61,1143,57,1,12,5,7
1994,1458,80,1153,72,1,9,8,1
1994,1112,81,1259,55,1,2,15,-13
1994,1116,94,1299,79,1,1,16,-15
1994,1130,67,1450,64,1,9,8,1
1994,1181,82,1411,70,1,2,15,-13
1994,1207,84,1228,77,1,9,8,1
1994,1231,84,1325,72,1,5,12,-7
1994,1246,83,1398,70,1,3,14,-11
1994,1257,67,1129,58,1,3,14,-11
1994,1266,81,1418,59,1,6,11,-5
1994,1277,84,1371,73,1,7,10,-3
1994,1278,74,1356,60,1,6,11,-5
1994,1314,71,1251,51,1,1,16,-15
1994,1329,65,1308,55,1,4,13,-9
1994,1396,61,1180,39,1,4,13,-9
1994,1409,112,1417,102,1,12,5,7
1994,1438,57,1307,54,1,7,10,-3
1994,1163,75,1203,63,1,2,10,-8
1994,1196,70,1335,58,1,3,11,-8
1994,1242,69,1448,58,1,4,5,-1
1994,1268,95,1269,87,1,10,2,8
1994,1276,84,1400,79,1,3,6,-3
1994,1281,109,1458,96,1,1,9,-8
1994,1345,83,1104,73,1,1,9,-8
1994,1393,64,1453,59,1,4,12,-8
1994,1112,71,1438,58,1,2,7,-5
1994,1116,85,1207,73,1,1,9,-8
1994,1130,75,1314,72,1,9,1,8
1994,1181,85,1277,74,1,2,7,-5
1994,1231,67,1396,58,1,5,4,1
1994,1257,60,1278,55,1,3,6,-3
1994,1266,75,1246,63,1,6,3,3
1994,1409,82,1329,80,1,12,4,8
1994,1112,82,1257,70,1,2,3,-1
1994,1181,59,1266,49,1,2,6,-4
1994,1281,98,1393,88,1,1,4,-3
1994,1345,83,1242,78,1,1,4,-3
1994,1116,103,1409,84,1,1,12,-11
1994,1130,77,1231,68,1,9,5,4
1994,1196,69,1163,60,1,3,2,1
1994,1276,78,1268,71,1,3,10,-7
1994,1112,92,1281,72,1,2,1,1
1994,1181,69,1345,60,1,2,1,1
1994,1116,76,1276,68,1,1,3,-2
1994,1196,74,1130,66,1,3,9,-6
1994,1116,91,1112,82,1,1,2,-1
1994,1181,70,1196,65,1,2,3,-1
1994,1116,76,1181,72,1,1,2,-1
1995,1104,91,1335,85,1,5,12,-7
1995,1113,81,1123,66,1,5,12,-7
1995,1153,77,1396,71,1,7,10,-3
1995,1163,100,1151,71,1,2,15,-13
1995,1242,82,1159,68,1,1,16,-15
1995,1246,113,1291,67,1,1,16,-15
1995,1264,77,1328,67,1,13,4,9
1995,1268,87,1211,63,1,3,14,-11
1995,1275,71,1112,62,1,12,5,7
1995,1329,73,1180,49,1,4,13,-9
1995,1387,64,1278,61,1,9,8,1
1995,1400,90,1332,73,1,11,6,5
1995,1408,76,1140,70,1,9,8,1
1995,1438,96,1311,72,1,4,13,-9
1995,1443,82,1276,76,1,8,9,-1
1995,1448,79,1299,47,1,1,16,-15
1995,1116,79,1411,78,1,2,15,-13
1995,1207,68,1462,63,1,6,11,-5
1995,1235,64,1196,61,1,7,10,-3
1995,1269,68,1389,51,1,2,15,-13
1995,1272,77,1257,56,1,6,11,-5
1995,1280,75,1365,67,1,5,12,-7
1995,1281,65,1231,60,1,8,9,-1
1995,1314,80,1293,70,1,2,15,-13
1995,1330,89,1437,81,1,14,3,11
1995,1345,49,1453,48,1,3,14,-11
1995,1390,70,1150,68,1,10,7,3
1995,1393,96,1356,92,1,7,10,-3
1995,1409,68,1228,62,1,6,11,-5
1995,1417,92,1198,56,1,1,16,-15
1995,1428,76,1253,64,1,4,13,-9
1995,1451,79,1277,72,1,14,3,11
1995,1113,64,1264,54,1,5,13,-8
1995,1163,96,1153,91,1,2,7,-5
1995,1242,75,1443,70,1,1,8,-7
1995,1246,82,1408,60,1,1,9,-8
1995,1268,82,1400,68,1,3,11,-8
1995,1329,66,1104,52,1,4,5,-1
1995,1438,60,1275,54,1,4,12,-8
1995,1448,64,1387,59,1,1,9,-8
1995,1116,96,1393,94,1,2,7,-5
1995,1207,53,1451,51,1,6,14,-8
1995,1269,75,1390,53,1,2,10,-8
1995,1272,75,1345,73,1,6,3,3
1995,1280,78,1428,64,1,5,4,1
1995,1314,73,1235,51,1,2,7,-5
1995,1409,64,1330,52,1,6,14,-8
1995,1417,75,1281,74,1,1,8,-7
1995,1163,99,1268,89,1,2,3,-1
1995,1246,97,1113,73,1,1,5,-4
1995,1314,74,1207,64,1,2,6,-4
1995,1417,86,1280,67,1,1,5,-4
1995,1116,96,1272,91,1,2,6,-4
1995,1269,76,1409,51,1,2,6,-4
1995,1329,71,1448,66,1,4,1,3
1995,1438,67,1242,58,1,4,1,3
1995,1314,74,1246,61,1,2,1,1
1995,1417,102,1163,96,1,1,2,-1
1995,1116,68,1438,61,1,2,4,-2
1995,1329,68,1269,54,1,4,2,2
1995,1116,75,1314,68,1,2,2,0
1995,1417,74,1329,61,1,1,4,-3
1995,1417,89,1116,78,1,1,2,-1
1996,1116,86,1336,80,1,12,5,7
1996,1163,68,1159,59,1,1,16,-15
1996,1180,75,1272,63,1,12,5,7
1996,1185,75,1181,60,1,9,8,1
1996,1208,81,1155,74,1,8,9,-1
1996,1235,74,1143,64,1,5,12,-7
1996,1246,110,1363,72,1,1,16,-15
1996,1266,68,1284,44,1,4,13,-9
1996,1269,92,1416,70,1,1,16,-15
1996,1280,58,1433,51,1,5,12,-7
1996,1343,43,1417,41,1,13,4,9
1996,1345,73,1441,71,1,1,16,-15
1996,1390,66,1133,58,1,9,8,1
1996,1393,88,1286,55,1,4,13,-9
1996,1428,72,1145,43,1,4,13,-9
1996,1439,61,1453,48,1,9,8,1
1996,1112,90,1434,51,1,3,14,-11
1996,1130,64,1231,51,1,11,6,5
1996,1153,66,1422,61,1,2,15,-13
1996,1207,93,1290,56,1,2,15,-13
1996,1210,90,1122,79,1,3,14,-11
1996,1234,81,1203,79,1,6,11,-5
1996,1242,92,1354,54,1,2,15,-13
1996,1257,82,1409,80,1,6,11,-5
1996,1307,69,1243,48,1,7,10,-3
1996,1314,83,1309,62,1,6,11,-5
1996,1365,91,1268,79,1,10,7,3
1996,1396,61,1328,43,1,7,10,-3
1996,1400,80,1276,76,1,10,7,3
1996,1403,74,1296,73,1,3,14,-11
1996,1437,92,1339,58,1,3,14,-11
1996,1448,62,1419,50,1,2,15,-13
1996,1116,65,1266,56,1,12,4,8
1996,1163,95,1185,81,1,1,9,-8
1996,1208,76,1345,69,1,8,1,7
1996,1246,84,1439,60,1,1,9,-8
1996,1269,79,1390,74,1,1,9,-8
1996,1280,63,1343,41,1,5,13,-8
1996,1393,69,1180,58,1,4,12,-8
1996,1428,73,1235,67,1,4,5,-1
1996,1112,87,1234,73,1,3,6,-3
1996,1153,78,1396,65,1,2,7,-5
1996,1207,73,1307,62,1,2,7,-5
1996,1210,103,1130,89,1,3,11,-8
1996,1242,76,1365,51,1,2,10,-8
1996,1257,68,1437,64,1,6,3,3
1996,1403,92,1314,73,1,3,6,-3
1996,1448,65,1400,62,1,2,10,-8
1996,1207,98,1403,90,1,2,3,-1
1996,1246,101,1428,70,1,1,4,-3
1996,1269,79,1116,63,1,1,12,-11
1996,1448,60,1257,59,1,2,6,-4
1996,1153,87,1210,70,1,2,3,-1
1996,1242,83,1112,80,1,2,3,-1
1996,1280,60,1163,55,1,5,1,4
1996,1393,83,1208,81,1,4,8,-4
1996,1246,83,1448,63,1,1,2,-1
1996,1269,86,1207,62,1,1,2,-1
1996,1280,73,1153,63,1,5,2,3
1996,1393,60,1242,57,1,4,2,2
1996,1246,81,1269,74,1,1,1,0
1996,1393,77,1280,69,1,4,5,-1
1996,1246,76,1393,67,1,1,4,-3
1997,1112,65,1375,57,1,4,13,-9
1997,1130,73,1434,66,1,5,12,-7
1997,1143,55,1343,52,1,5,12,-7
1997,1153,86,1139,69,1,3,14,-11
1997,1158,75,1268,66,1,12,5,7
1997,1160,80,1231,62,1,9,8,1
1997,1234,73,1438,60,1,8,9,-1
1997,1235,69,1229,57,1,6,11,-5
1997,1242,78,1238,64,1,1,16,-15
1997,1246,92,1285,54,1,1,16,-15
1997,1314,82,1193,74,1,1,16,-15
1997,1345,83,1348,76,1,8,9,-1
1997,1386,75,1334,65,1,4,13,-9
1997,1417,109,1149,75,1,2,15,-13
1997,1437,101,1254,91,1,4,13,-9
1997,1462,80,1435,68,1,7,10,-3
1997,1150,79,1207,67,1,7,10,-3
1997,1151,73,1208,70,1,14,3,11
1997,1155,68,1275,56,1,4,13,-9
1997,1164,78,1376,65,1,15,2,13
1997,1181,71,1293,68,1,2,15,-13
1997,1228,90,1425,77,1,6,11,-5
1997,1257,65,1269,57,1,6,11,-5
1997,1278,78,1402,46,1,1,16,-15
1997,1307,59,1330,55,1,3,14,-11
1997,1344,81,1266,59,1,10,7,3
1997,1390,80,1328,67,1,6,11,-5
1997,1396,62,1279,40,1,9,8,1
1997,1400,71,1458,58,1,10,7,3
1997,1409,81,1131,52,1,5,12,-7
1997,1428,75,1298,61,1,2,15,-13
1997,1448,68,1388,46,1,3,14,-11
1997,1112,73,1158,69,1,4,12,-8
1997,1143,75,1437,68,1,5,4,1
1997,1235,67,1153,66,1,6,3,3
1997,1242,75,1345,61,1,1,8,-7
1997,1246,75,1234,69,1,1,8,-7
1997,1314,73,1160,56,1,1,9,-8
1997,1386,81,1130,77,1,4,5,-1
1997,1417,96,1462,83,1,2,7,-5
1997,1151,75,1228,63,1,14,6,8
1997,1155,65,1409,59,1,4,5,-1
1997,1257,64,1307,63,1,6,3,3
1997,1278,76,1396,57,1,1,9,-8
1997,1344,98,1181,87,1,10,2,8
1997,1390,72,1448,66,1,6,3,3
1997,1400,82,1164,81,1,10,15,-5
1997,1428,77,1150,58,1,2,7,-5
1997,1246,83,1386,68,1,1,4,-3
1997,1278,90,1155,84,1,1,4,-3
1997,1417,74,1235,73,1,2,6,-4
1997,1428,82,1390,77,1,2,6,-4
1997,1112,85,1242,82,1,4,1,3
1997,1257,78,1400,63,1,6,10,-4
1997,1314,63,1143,57,1,1,5,-4
1997,1344,71,1151,65,1,10,14,-4
1997,1246,72,1428,59,1,1,2,-1
1997,1278,80,1417,72,1,1,2,-1
1997,1112,96,1344,92,1,4,10,-6
1997,1314,97,1257,74,1,1,6,-5
1997,1112,66,1314,58,1,4,1,3
1997,1246,78,1278,69,1,1,1,0
1997,1112,84,1246,79,1,4,1,3
1998,1112,99,1311,60,1,1,16,-15
1998,1116,74,1304,65,1,6,11,-5
1998,1150,77,1227,62,1,8,9,-1
1998,1153,65,1319,62,1,2,15,-13
1998,1163,93,1192,85,1,2,15,-13
1998,1228,64,1375,51,1,5,12,-7
1998,1229,82,1397,81,1,9,8,1
1998,1231,94,1328,87,1,7,10,-3
1998,1268,82,1429,68,1,4,13,-9
1998,1277,83,1185,71,1,4,13,-9
1998,1314,88,1298,52,1,1,16,-15
1998,1343,69,1424,57,1,5,12,-7
1998,1350,62,1376,61,1,14,3,11
1998,1428,85,1362,68,1,3,14,-11
1998,1449,69,1462,68,1,11,6,5
1998,1452,82,1396,52,1,10,7,3
1998,1178,66,1385,64,1,10,7,3
1998,1181,99,1347,63,1,1,16,-15
1998,1199,96,1395,87,1,12,5,7
1998,1242,110,1341,52,1,1,16,-15
1998,1246,82,1354,67,1,2,15,-13
1998,1276,80,1172,61,1,3,14,-11
1998,1307,79,1139,62,1,4,13,-9
1998,1329,74,1203,59,1,8,9,-1
1998,1345,95,1174,56,1,2,15,-13
1998,1348,97,1293,74,1,8,9,-1
1998,1387,51,1269,46,1,10,7,3
1998,1390,67,1158,57,1,3,14,-11
1998,1393,63,1233,61,1,5,12,-7
1998,1417,65,1274,62,1,6,11,-5
1998,1434,70,1279,69,1,13,4,9
1998,1444,75,1155,72,1,11,6,5
1998,1112,82,1229,49,1,1,9,-8
1998,1163,78,1231,68,1,2,7,-5
1998,1268,67,1228,61,1,4,5,-1
1998,1277,63,1343,56,1,4,5,-1
1998,1314,93,1150,83,1,1,8,-7
1998,1428,75,1116,69,1,3,6,-3
1998,1449,81,1350,66,1,11,14,-3
1998,1452,75,1153,74,1,10,2,8
1998,1181,79,1329,73,1,1,8,-7
1998,1246,88,1387,61,1,2,10,-8
1998,1345,80,1178,65,1,2,10,-8
1998,1348,80,1242,75,1,8,1,7
1998,1390,83,1444,65,1,3,11,-8
1998,1393,56,1307,46,1,5,4,1
1998,1417,85,1276,82,1,6,3,3
1998,1434,83,1199,77,1,13,12,1
1998,1112,87,1268,79,1,1,4,-3
1998,1163,75,1449,74,1,2,11,-9
1998,1314,73,1277,58,1,1,4,-3
1998,1428,65,1452,62,1,3,10,-7
1998,1181,80,1393,67,1,1,5,-4
1998,1246,94,1417,68,1,2,6,-4
1998,1348,74,1434,68,1,8,13,-5
1998,1390,67,1345,59,1,3,2,1
1998,1314,75,1163,64,1,1,2,-1
1998,1428,76,1112,51,1,3,1,2
1998,1246,86,1181,84,1,2,1,1
1998,1390,79,1348,77,1,3,8,-5
1998,1246,86,1390,85,1,2,3,-1
1998,1428,65,1314,59,1,3,1,2
1998,1246,78,1428,69,1,2,3,-1
1999,1116,94,1373,80,1,4,13,-9
1999,1120,80,1457,41,1,1,16,-15
1999,1163,91,1427,66,1,1,16,-15
1999,1166,62,1257,58,1,10,7,3
1999,1178,56,1417,53,1,12,5,7
1999,1196,75,1335,61,1,6,11,-5
1999,1211,75,1278,63,1,10,7,3
1999,1231,108,1203,88,1,6,11,-5
1999,1234,77,1412,64,1,5,12,-7
1999,1268,82,1434,60,1,2,15,-13
1999,1307,61,1281,59,1,9,8,1
1999,1326,72,1293,58,1,4,13,-9
1999,1329,69,1393,61,1,9,8,1
1999,1385,69,1359,43,1,3,14,-11
1999,1390,69,1108,57,1,2,15,-13
1999,1451,76,1314,74,1,14,3,11
1999,1150,81,1348,70,1,5,12,-7
1999,1153,72,1206,48,1,3,14,-11
1999,1181,99,1197,58,1,1,16,-15
1999,1242,95,1191,74,1,6,11,-5
1999,1246,82,1308,60,1,3,14,-11
1999,1274,75,1248,54,1,2,15,-13
1999,1275,59,1449,58,1,10,7,3
1999,1277,76,1291,53,1,1,16,-15
1999,1279,72,1437,70,1,9,8,1
1999,1283,43,1458,32,1,12,5,7
1999,1328,61,1112,60,1,13,4,9
1999,1345,58,1400,54,1,10,7,3
1999,1396,61,1245,54,1,6,11,-5
1999,1397,62,1174,52,1,4,13,-9
1999,1409,62,1158,53,1,9,8,1
1999,1428,80,1117,58,1,2,15,-13
1999,1120,81,1329,74,1,1,9,-8
1999,1163,78,1307,56,1,1,9,-8
1999,1196,82,1451,74,1,6,14,-8
1999,1211,82,1390,74,1,10,2,8
1999,1234,82,1116,72,1,5,4,1
1999,1268,75,1166,63,1,2,10,-8
1999,1326,75,1178,44,1,4,12,-8
1999,1385,86,1231,61,1,3,6,-3
1999,1181,97,1409,56,1,1,9,-8
1999,1246,92,1242,88,1,3,6,-3
1999,1275,66,1428,58,1,10,2,8
1999,1277,74,1279,66,1,1,9,-8
1999,1283,81,1397,51,1,12,4,8
1999,1328,85,1150,72,1,13,5,8
1999,1345,73,1274,63,1,10,2,8
1999,1396,64,1153,54,1,6,3,3
1999,1163,78,1234,68,1,1,5,-4
1999,1211,73,1196,72,1,10,6,4
1999,1326,72,1120,64,1,4,1,3
1999,1385,76,1268,62,1,3,2,1
1999,1181,78,1283,61,1,1,12,-11
1999,1246,58,1275,43,1,3,10,-7
1999,1277,54,1328,46,1,1,13,-12
1999,1396,77,1345,55,1,6,10,-4
1999,1163,67,1211,62,1,1,10,-9
1999,1326,77,1385,74,1,4,3,1
1999,1181,85,1396,64,1,1,6,-5
1999,1277,73,1246,66,1,1,3,-2
1999,1163,64,1326,58,1,1,4,-3
1999,1181,68,1277,62,1,1,1,0
1999,1163,77,1181,74,1,1,1,0
2000,1112,71,1238,47,1,1,16,-15
2000,1120,72,1166,69,1,7,10,-3
2000,1211,77,1257,66,1,10,7,3
2000,1235,88,1148,78,1,2,15,-13
2000,1246,85,1382,80,1,5,12,-7
2000,1261,64,1369,61,1,4,13,-9
2000,1268,74,1233,59,1,3,14,-11
2000,1277,65,1434,38,1,1,16,-15
2000,1328,74,1457,50,1,3,14,-11
2000,1345,62,1173,61,1,6,11,-5
2000,1385,61,1319,56,1,2,15,-13
2000,1393,79,1359,65,1,4,13,-9
2000,1400,77,1232,61,1,5,12,-7
2000,1417,65,1123,57,1,6,11,-5
2000,1428,48,1387,45,1,8,9,-1
2000,1458,66,1201,56,1,8,9,-1
2000,1153,64,1423,47,1,2,15,-13
2000,1163,75,1429,67,1,5,12,-7
2000,1181,82,1249,55,1,1,16,-15
2000,1196,69,1139,68,1,5,12,-7
2000,1228,68,1335,58,1,4,13,-9
2000,1242,81,1177,77,1,8,9,-1
2000,1274,75,1116,71,1,6,11,-5
2000,1314,84,1281,70,1,8,9,-1
2000,1326,87,1111,61,1,3,14,-11
2000,1329,86,1220,66,1,3,14,-11
2000,1337,77,1231,57,1,11,6,5
2000,1371,72,1332,71,1,10,7,3
2000,1390,84,1354,65,1,1,16,-15
2000,1396,73,1248,47,1,2,15,-13
2000,1397,63,1418,58,1,4,13,-9
2000,1409,89,1424,62,1,7,10,-3
2000,1211,82,1385,76,1,10,2,8
2000,1235,79,1120,60,1,2,7,-5
2000,1261,72,1400,67,1,4,5,-1
2000,1277,73,1428,61,1,1,8,-7
2000,1345,66,1328,62,1,6,3,3
2000,1393,52,1246,50,1,4,5,-1
2000,1417,105,1268,70,1,6,3,3
2000,1458,66,1112,59,1,8,1,7
2000,1181,69,1242,64,1,1,8,-7
2000,1196,93,1228,76,1,5,4,1
2000,1274,75,1326,62,1,6,3,3
2000,1314,60,1390,53,1,8,1,7
2000,1329,75,1337,67,1,3,11,-8
2000,1371,67,1396,65,1,10,2,8
2000,1397,65,1163,51,1,4,5,-1
2000,1409,69,1153,61,1,7,2,5
2000,1235,80,1417,56,1,2,6,-4
2000,1277,75,1393,58,1,1,4,-3
2000,1345,75,1211,66,1,6,10,-4
2000,1458,61,1261,48,1,8,4,4
2000,1196,87,1181,78,1,5,1,4
2000,1314,74,1397,69,1,8,4,4
2000,1329,68,1371,66,1,3,10,-7
2000,1409,80,1274,71,1,7,6,1
2000,1277,75,1235,64,1,1,2,-1
2000,1458,64,1345,60,1,8,6,2
2000,1196,77,1329,65,1,5,3,2
2000,1314,59,1409,55,1,8,7,1
2000,1196,71,1314,59,1,5,8,-3
2000,1277,53,1458,41,1,1,8,-7
2000,1277,89,1196,76,1,1,5,-4
2001,1322,71,1457,67,1,16,16,0
2001,1130,68,1381,65,1,3,14,-11
2001,1153,84,1140,59,1,5,12,-7
2001,1181,95,1284,52,1,1,16,-15
2001,1207,63,1116,61,1,10,7,3
2001,1209,50,1458,49,1,11,6,5
2001,1214,58,1235,57,1,15,2,13
2001,1234,69,1166,56,1,7,10,-3
2001,1245,77,1231,73,1,13,4,9
2001,1246,72,1221,68,1,2,15,-13
2001,1268,83,1206,80,1,3,14,-11
2001,1281,70,1208,68,1,9,8,1
2001,1386,66,1210,62,1,9,8,1
2001,1390,89,1422,60,1,1,16,-15
2001,1417,61,1220,48,1,4,13,-9
2001,1425,69,1329,54,1,6,11,-5
2001,1429,77,1326,68,1,12,5,7
2001,1112,101,1183,76,1,2,15,-13
2001,1139,79,1448,63,1,10,7,3
2001,1150,70,1397,63,1,9,8,1
2001,1196,69,1443,56,1,3,14,-11
2001,1201,82,1143,70,1,9,8,1
2001,1211,86,1438,85,1,12,5,7
2001,1228,96,1322,54,1,1,16,-15
2001,1232,70,1328,68,1,13,4,9
2001,1242,99,1169,75,1,4,13,-9
2001,1277,69,1106,35,1,1,16,-15
2001,1279,72,1233,70,1,3,14,-11
2001,1314,70,1343,48,1,2,15,-13
2001,1323,83,1462,71,1,6,11,-5
2001,1336,69,1344,59,1,7,10,-3
2001,1393,79,1218,69,1,5,12,-7
2001,1396,79,1400,65,1,11,6,5
2001,1153,66,1245,43,1,5,13,-8
2001,1181,94,1281,81,1,1,9,-8
2001,1207,76,1214,57,1,10,15,-5
2001,1246,92,1234,79,1,2,7,-5
2001,1268,79,1209,60,1,3,11,-8
2001,1390,90,1386,83,1,1,9,-8
2001,1417,75,1429,50,1,4,12,-8
2001,1425,74,1130,71,1,6,3,3
2001,1112,73,1139,52,1,2,10,-8
2001,1211,85,1232,68,1,12,13,-1
2001,1228,79,1150,61,1,1,9,-8
2001,1242,87,1393,58,1,4,5,-1
2001,1277,81,1201,65,1,1,9,-8
2001,1279,59,1323,56,1,3,6,-3
2001,1336,82,1314,74,1,7,2,5
2001,1396,75,1196,54,1,11,3,8
2001,1181,76,1417,63,1,1,4,-3
2001,1268,76,1207,66,1,3,10,-7
2001,1390,78,1153,65,1,1,5,-4
2001,1425,80,1246,76,1,6,2,4
2001,1112,66,1279,56,1,2,3,-1
2001,1228,80,1242,64,1,1,4,-3
2001,1277,77,1211,62,1,1,12,-11
2001,1396,84,1336,72,1,11,7,4
2001,1181,79,1425,69,1,1,6,-5
2001,1268,87,1390,73,1,3,1,2
2001,1112,87,1228,81,1,2,1,1
2001,1277,69,1396,62,1,1,11,-10
2001,1112,80,1277,61,1,2,1,1
2001,1181,95,1268,84,1,1,3,-2
2001,1181,82,1112,72,1,1,2,-1
2002,1373,81,1108,77,1,16,16,0
2002,1104,86,1194,78,1,2,15,-13
2002,1112,86,1364,81,1,3,14,-11
2002,1181,84,1457,37,1,1,16,-15
2002,1231,75,1428,56,1,5,12,-7
2002,1242,70,1221,59,1,1,16,-15
2002,1245,69,1329,61,1,10,7,3
2002,1246,83,1434,68,1,4,13,-9
2002,1281,93,1274,80,1,12,5,7
2002,1323,82,1150,63,1,8,9,-1
2002,1326,69,1172,64,1,4,13,-9
2002,1332,81,1285,62,1,2,15,-13
2002,1390,84,1443,68,1,8,9,-1
2002,1409,71,1266,69,1,12,5,7
2002,1423,93,1425,89,1,13,4,9
2002,1448,83,1337,74,1,7,10,-3
2002,1461,73,1211,66,1,11,6,5
2002,1143,82,1335,75,1,6,11,-5
2002,1153,90,1131,52,1,1,16,-15
2002,1163,78,1214,67,1,2,15,-13
2002,1166,83,1196,82,1,12,5,7
2002,1208,85,1293,68,1,3,14,-11
2002,1228,93,1361,64,1,4,13,-9
2002,1268,85,1373,70,1,1,16,-15
2002,1280,70,1270,58,1,3,14,-11
2002,1301,69,1277,58,1,7,10,-3
2002,1328,71,1227,63,1,2,15,-13
2002,1338,71,1148,54,1,3,14,-11
2002,1356,76,1403,68,1,11,6,5
2002,1400,70,1130,57,1,6,11,-5
2002,1417,80,1279,58,1,8,9,-1
2002,1458,80,1385,70,1,8,9,-1
2002,1462,70,1218,58,1,7,10,-3
2002,1112,68,1461,60,1,3,11,-8
2002,1181,84,1323,77,1,1,8,-7
2002,1231,76,1423,67,1,5,13,-8
2002,1242,86,1390,63,1,1,8,-7
2002,1245,71,1104,58,1,10,2,8
2002,1246,87,1409,82,1,4,12,-8
2002,1281,83,1326,67,1,12,4,8
2002,1332,92,1448,87,1,2,7,-5
2002,1163,77,1301,74,1,2,7,-5
2002,1228,72,1166,60,1,4,12,-8
2002,1268,87,1458,57,1,1,8,-7
2002,1328,78,1462,65,1,2,7,-5
2002,1338,63,1143,50,1,3,6,-3
2002,1356,77,1208,75,1,11,3,8
2002,1400,68,1280,64,1,6,3,3
2002,1417,105,1153,101,1,8,1,7
2002,1231,74,1181,73,1,5,1,4
2002,1245,78,1338,73,1,10,3,7
2002,1281,82,1417,73,1,12,8,4
2002,1328,88,1112,67,1,2,3,-1
2002,1163,71,1356,59,1,2,11,-9
2002,1242,73,1228,69,1,1,4,-3
2002,1268,78,1246,68,1,1,4,-3
2002,1332,72,1400,70,1,2,6,-4
2002,1231,81,1245,69,1,5,10,-5
2002,1328,81,1281,75,1,2,12,-10
2002,1242,104,1332,86,1,1,2,-1
2002,1268,90,1163,82,1,1,2,-1
2002,1231,73,1328,64,1,5,2,3
2002,1268,97,1242,88,1,1,1,0
2002,1268,64,1231,52,1,1,5,-4
2003,1421,92,1411,84,1,16,16,0
2003,1112,80,1436,51,1,1,16,-15
2003,1113,84,1272,71,1,10,7,3
2003,1141,79,1166,73,1,11,6,5
2003,1143,76,1301,74,1,8,9,-1
2003,1163,58,1140,53,1,5,12,-7
2003,1181,67,1161,57,1,3,14,-11
2003,1211,74,1153,69,1,9,8,1
2003,1228,65,1443,60,1,4,13,-9
2003,1242,64,1429,61,1,2,15,-13
2003,1266,72,1221,68,1,3,14,-11
2003,1281,72,1356,71,1,6,11,-5
2003,1323,70,1454,69,1,5,12,-7
2003,1328,71,1354,54,1,1,16,-15
2003,1390,77,1360,69,1,4,13,-9
2003,1409,84,1173,71,1,13,4,9
2003,1458,81,1451,74,1,5,12,-7
2003,1120,65,1386,63,1,10,7,3
2003,1139,47,1280,46,1,12,5,7
2003,1196,85,1358,55,1,2,15,-13
2003,1231,67,1104,62,1,7,10,-3
2003,1246,95,1237,64,1,1,16,-15
2003,1257,86,1122,64,1,4,13,-9
2003,1268,75,1423,73,1,6,11,-5
2003,1277,79,1160,64,1,7,10,-3
2003,1329,77,1335,63,1,6,11,-5
2003,1338,87,1447,61,1,2,15,-13
2003,1345,80,1261,56,1,9,8,1
2003,1393,76,1264,65,1,3,14,-11
2003,1400,82,1421,61,1,1,16,-15
2003,1428,60,1332,58,1,9,8,1
2003,1448,76,1190,73,1,2,15,-13
2003,1462,71,1407,59,1,3,14,-11
2003,1112,96,1211,95,1,1,9,-8
2003,1163,85,1390,74,1,5,4,1
2003,1181,86,1141,60,1,3,11,-8
2003,1242,108,1113,76,1,2,10,-8
2003,1266,101,1281,92,1,3,6,-3
2003,1323,68,1228,60,1,5,4,1
2003,1328,74,1143,65,1,1,8,-7
2003,1458,61,1409,60,1,5,13,-8
2003,1120,68,1448,62,1,10,2,8
2003,1139,79,1257,71,1,12,4,8
2003,1246,74,1428,54,1,1,9,-8
2003,1268,77,1462,64,1,6,3,3
2003,1277,68,1196,46,1,7,2,5
2003,1338,74,1231,52,1,2,7,-5
2003,1393,68,1329,56,1,3,6,-3
2003,1400,77,1345,67,1,1,9,-8
2003,1112,88,1323,71,1,1,5,-4
2003,1242,69,1181,65,1,2,3,-1
2003,1246,63,1458,57,1,1,5,-4
2003,1266,77,1338,74,1,3,2,1
2003,1277,60,1268,58,1,7,6,1
2003,1328,65,1139,54,1,1,12,-11
2003,1393,79,1120,78,1,3,10,-7
2003,1400,82,1163,78,1,1,5,-4
2003,1242,78,1112,75,1,2,1,1
2003,1266,83,1246,69,1,3,1,2
2003,1393,63,1328,47,1,3,1,2
2003,1400,85,1277,76,1,1,7,-6
2003,1242,94,1266,61,1,2,3,-1
2003,1393,95,1400,84,1,3,1,2
2003,1393,81,1242,78,1,3,2,1
2004,1197,72,1250,57,1,16,16,0
2004,1104,65,1356,64,1,8,9,-1
2004,1163,70,1436,53,1,2,15,-13
2004,1177,76,1173,69,1,7,10,-3
2004,1181,96,1106,61,1,1,16,-15
2004,1211,76,1434,49,1,2,15,-13
2004,1264,75,1196,60,1,12,5,7
2004,1268,86,1431,83,1,4,13,-9
2004,1305,72,1277,66,1,10,7,3
2004,1314,63,1102,52,1,6,11,-5
2004,1371,80,1112,76,1,8,9,-1
2004,1386,82,1251,63,1,1,16,-15
2004,1390,71,1427,45,1,1,16,-15
2004,1393,80,1140,75,1,5,12,-7
2004,1400,66,1343,49,1,3,14,-11
2004,1403,76,1150,73,1,8,9,-1
2004,1448,79,1433,78,1,4,13,-9
2004,1130,58,1428,51,1,6,11,-5
2004,1153,80,1190,77,1,4,13,-9
2004,1210,65,1320,60,1,3,14,-11
2004,1228,72,1293,53,1,5,12,-7
2004,1242,78,1227,53,1,4,13,-9
2004,1246,96,1197,76,1,1,16,-15
2004,1272,59,1376,43,1,7,10,-3
2004,1280,85,1284,52,1,2,15,-13
2004,1301,61,1418,52,1,3,14,-11
2004,1329,75,1186,56,1,2,15,-13
2004,1334,66,1344,58,1,12,5,7
2004,1338,53,1416,44,1,3,14,-11
2004,1412,102,1449,100,1,9,8,1
2004,1435,71,1444,58,1,6,11,-5
2004,1458,76,1350,64,1,6,11,-5
2004,1462,80,1257,70,1,7,10,-3
2004,1104,70,1390,67,1,8,1,7
2004,1163,72,1177,55,1,2,7,-5
2004,1181,90,1371,62,1,1,8,-7
2004,1305,91,1211,72,1,10,2,8
2004,1386,70,1403,65,1,1,8,-7
2004,1393,72,1268,70,1,5,4,1
2004,1400,78,1314,75,1,3,6,-3
2004,1448,84,1264,80,1,4,12,-8
2004,1210,57,1130,54,1,3,6,-3
2004,1228,92,1153,68,1,5,4,1
2004,1242,78,1334,63,1,4,12,-8
2004,1329,70,1272,53,1,2,7,-5
2004,1338,59,1458,55,1,3,6,-3
2004,1412,76,1246,75,1,9,1,8
2004,1435,75,1301,73,1,6,3,3
2004,1462,89,1280,74,1,7,2,5
2004,1104,80,1393,71,1,8,5,3
2004,1163,73,1435,53,1,2,6,-4
2004,1329,63,1338,51,1,2,3,-1
2004,1386,84,1448,80,1,1,4,-3
2004,1181,72,1228,62,1,1,5,-4
2004,1210,72,1305,67,1,3,10,-7
2004,1242,100,1412,74,1,4,9,-5
2004,1462,79,1400,71,1,7,3,4
2004,1163,87,1104,71,1,2,8,-6
2004,1329,64,1386,62,1,2,1,1
2004,1181,66,1462,63,1,1,7,-6
2004,1210,79,1242,71,1,3,4,-1
2004,1163,79,1181,78,1,2,1,1
2004,1210,67,1329,65,1,3,2,1
2004,1163,82,1210,73,1,2,3,-1
2005,1324,79,1105,69,1,16,16,0
2005,1112,66,1429,53,1,3,14,-11
2005,1130,85,1335,65,1,4,13,-9
2005,1153,76,1234,64,1,7,10,-3
2005,1211,74,1457,64,1,3,14,-11
2005,1228,67,1192,55,1,1,16,-15
2005,1246,72,1184,64,1,2,15,-13
2005,1305,61,1400,57,1,9,8,1
2005,1328,84,1310,67,1,3,14,-11
2005,1334,79,1338,71,1,8,9,-1
2005,1403,78,1417,66,1,6,11,-5
2005,1412,82,1261,68,1,11,6,5
2005,1428,60,1431,54,1,6,11,-5
2005,1448,70,1151,54,1,2,15,-13
2005,1449,88,1285,77,1,1,16,-15
2005,1452,63,1166,61,1,7,10,-3
2005,1454,83,1104,73,1,12,5,7
2005,1137,64,1242,63,1,14,3,11
2005,1163,77,1416,71,1,2,15,-13
2005,1181,57,1175,46,1,1,16,-15
2005,1196,67,1325,62,1,4,13,-9
2005,1210,80,1203,68,1,5,12,-7
2005,1235,64,1278,53,1,9,8,1
2005,1257,68,1418,62,1,4,13,-9
2005,1277,89,1330,81,1,5,12,-7
2005,1280,93,1390,70,1,9,8,1
2005,1301,75,1150,63,1,10,7,3
2005,1314,96,1324,68,1,1,16,-15
2005,1329,63,1368,50,1,2,15,-13
2005,1356,65,1388,56,1,7,10,-3
2005,1436,60,1393,57,1,13,4,9
2005,1437,55,1307,47,1,5,12,-7
2005,1458,57,1320,52,1,6,11,-5
2005,1112,85,1412,63,1,3,11,-8
2005,1228,71,1305,59,1,1,9,-8
2005,1246,69,1153,60,1,2,7,-5
2005,1403,71,1211,69,1,6,3,3
2005,1428,67,1328,58,1,6,3,3
2005,1449,97,1334,79,1,1,8,-7
2005,1452,111,1448,105,1,7,2,5
2005,1454,83,1130,75,1,12,4,8
2005,1181,63,1280,55,1,1,9,-8
2005,1257,76,1210,54,1,4,5,-1
2005,1277,72,1436,61,1,5,13,-8
2005,1301,65,1163,62,1,10,2,8
2005,1314,92,1235,65,1,1,9,-8
2005,1329,85,1356,77,1,2,7,-5
2005,1437,76,1196,65,1,5,4,1
2005,1458,71,1137,62,1,6,14,-8
2005,1112,79,1329,78,1,3,2,1
2005,1228,77,1454,63,1,1,12,-11
2005,1257,93,1449,79,1,4,1,3
2005,1452,65,1403,60,1,7,6,1
2005,1246,62,1428,52,1,2,6,-4
2005,1277,78,1181,68,1,5,1,4
2005,1314,67,1437,66,1,1,5,-4
2005,1458,65,1301,56,1,6,10,-4
2005,1228,90,1112,89,1,1,3,-2
2005,1257,93,1452,85,1,4,7,-3
2005,1277,94,1246,88,1,5,2,3
2005,1314,88,1458,82,1,1,6,-5
2005,1228,72,1257,57,1,1,4,-3
2005,1314,87,1277,71,1,1,5,-4
2005,1314,75,1228,70,1,1,1,0
2006,1284,71,1214,49,1,16,16,0
2006,1104,90,1266,85,1,10,7,3
2006,1130,88,1334,76,1,4,13,-9
2006,1181,70,1380,54,1,1,16,-15
2006,1196,76,1375,50,1,3,14,-11
2006,1203,88,1423,85,1,8,9,-1
2006,1211,79,1462,75,1,3,14,-11
2006,1228,78,1102,69,1,4,13,-9
2006,1231,87,1361,83,1,6,11,-5
2006,1261,80,1233,64,1,4,13,-9
2006,1285,87,1305,79,1,12,5,7
2006,1397,63,1457,61,1,2,15,-13
2006,1401,66,1393,58,1,12,5,7
2006,1417,78,1125,44,1,2,15,-13
2006,1449,75,1429,61,1,5,12,-7
2006,1454,82,1328,74,1,11,6,5
2006,1455,86,1371,66,1,7,10,-3
2006,1112,94,1458,75,1,8,9,-1
2006,1133,77,1242,73,1,13,4,9
2006,1137,59,1116,55,1,9,8,1
2006,1163,72,1107,59,1,1,16,-15
2006,1206,75,1277,65,1,11,6,5
2006,1207,54,1320,49,1,7,10,-3
2006,1246,69,1412,64,1,8,9,-1
2006,1272,94,1331,78,1,1,16,-15
2006,1301,58,1143,52,1,10,7,3
2006,1314,69,1293,65,1,3,14,-11
2006,1322,64,1234,63,1,14,3,11
2006,1326,70,1172,62,1,2,15,-13
2006,1338,79,1245,64,1,5,12,-7
2006,1400,60,1335,52,1,2,15,-13
2006,1437,58,1284,45,1,1,16,-15
2006,1452,64,1356,46,1,6,11,-5
2006,1130,69,1285,56,1,4,12,-8
2006,1181,74,1203,61,1,1,8,-7
2006,1196,82,1454,60,1,3,11,-8
2006,1211,90,1231,80,1,3,6,-3
2006,1261,58,1401,57,1,4,12,-8
2006,1417,62,1104,59,1,2,10,-8
2006,1449,67,1228,64,1,5,4,1
2006,1455,80,1397,73,1,7,2,5
2006,1133,72,1338,66,1,13,5,8
2006,1163,87,1246,83,1,1,8,-7
2006,1206,65,1314,60,1,11,3,8
2006,1207,70,1326,52,1,7,2,5
2006,1272,72,1137,56,1,1,9,-8
2006,1400,75,1301,54,1,2,10,-8
2006,1437,82,1112,78,1,1,8,-7
2006,1452,67,1322,54,1,6,14,-8
2006,1261,62,1181,54,1,4,1,3
2006,1272,80,1133,64,1,1,13,-12
2006,1400,74,1452,71,1,2,6,-4
2006,1417,73,1211,71,1,2,3,-1
2006,1163,98,1449,92,1,1,5,-4
2006,1196,57,1207,53,1,3,7,-4
2006,1206,63,1455,55,1,11,7,4
2006,1437,60,1130,59,1,1,4,-3
2006,1261,70,1400,60,1,4,2,2
2006,1417,50,1272,45,1,2,1,1
2006,1196,75,1437,62,1,3,1,2
2006,1206,86,1163,84,1,11,1,10
2006,1196,73,1206,58,1,3,11,-8
2006,1417,59,1261,45,1,2,4,-2
2006,1196,73,1417,57,1,3,2,1
2007,1310,77,1197,69,1,16,16,0
2007,1130,84,1403,75,1,7,10,-3
2007,1139,57,1330,46,1,5,12,-7
2007,1207,80,1125,55,1,2,15,-13
2007,1231,70,1211,57,1,7,10,-3
2007,1257,78,1390,58,1,6,11,-5
2007,1268,82,1172,70,1,4,13,-9
2007,1277,61,1266,49,1,9,8,1
2007,1314,86,1184,65,1,1,16,-15
2007,1326,78,1148,57,1,1,16,-15
2007,1338,79,1460,58,1,3,14,-11
2007,1401,68,1335,52,1,3,14,-11
2007,1417,70,1451,42,1,2,15,-13
2007,1433,79,1181,77,1,11,6,5
2007,1435,77,1203,44,1,6,11,-5
2007,1450,70,1331,54,1,3,14,-11
2007,1462,79,1140,77,1,9,8,1
2007,1196,112,1238,69,1,1,16,-15
2007,1242,107,1310,67,1,1,16,-15
2007,1246,67,1437,58,1,8,9,-1
2007,1272,73,1317,58,1,2,15,-13
2007,1305,77,1166,71,1,7,10,-3
2007,1332,58,1275,56,1,3,14,-11
2007,1345,72,1112,63,1,9,8,1
2007,1356,61,1221,51,1,4,13,-9
2007,1397,121,1253,86,1,5,12,-7
2007,1400,79,1308,67,1,4,13,-9
2007,1424,67,1210,63,1,7,10,-3
2007,1425,77,1116,60,1,5,12,-7
2007,1438,84,1107,57,1,4,13,-9
2007,1439,54,1228,52,1,5,12,-7
2007,1457,74,1323,64,1,11,6,5
2007,1458,76,1394,63,1,2,15,-13
2007,1139,62,1268,59,1,5,4,1
2007,1207,62,1130,55,1,2,7,-5
2007,1314,81,1277,67,1,1,9,-8
2007,1326,78,1462,71,1,1,9,-8
2007,1338,84,1433,79,1,3,11,-8
2007,1401,72,1257,69,1,3,6,-3
2007,1417,54,1231,49,1,2,7,-5
2007,1435,78,1450,74,1,6,3,3
2007,1196,74,1345,67,1,1,9,-8
2007,1242,88,1246,76,1,1,8,-7
2007,1272,78,1305,62,1,2,7,-5
2007,1332,75,1457,61,1,3,11,-8
2007,1356,63,1439,48,1,4,5,-1
2007,1397,77,1438,74,1,5,4,1
2007,1424,74,1458,68,1,7,2,5
2007,1425,87,1400,68,1,5,4,1
2007,1242,61,1356,58,1,1,4,-3
2007,1272,65,1401,64,1,2,3,-1
2007,1326,85,1397,84,1,1,5,-4
2007,1417,64,1338,55,1,2,3,-1
2007,1196,65,1139,57,1,1,5,-4
2007,1207,66,1435,65,1,2,6,-4
2007,1314,74,1425,64,1,1,5,-4
2007,1332,76,1424,72,1,3,7,-4
2007,1326,92,1272,76,1,1,2,-1
2007,1417,68,1242,55,1,2,1,1
2007,1196,85,1332,77,1,1,3,-2
2007,1207,96,1314,84,1,2,1,1
2007,1196,76,1417,66,1,1,2,-1
2007,1326,67,1207,60,1,1,2,-1
2007,1196,84,1326,75,1,1,1,0
2008,1291,69,1164,60,1,16,16,0
2008,1181,71,1125,70,1,2,15,-13
2008,1242,85,1340,61,1,1,16,-15
2008,1243,80,1425,67,1,11,6,5
2008,1266,74,1246,66,1,6,11,-5
2008,1277,72,1396,61,1,5,12,-7
2008,1323,68,1206,50,1,5,12,-7
2008,1338,82,1331,63,1,4,13,-9
2008,1345,90,1124,79,1,6,11,-5
2008,1390,77,1165,53,1,3,14,-11
2008,1401,67,1140,62,1,9,8,1
2008,1417,70,1290,29,1,1,16,-15
2008,1424,71,1245,58,1,8,9,-1
2008,1450,71,1457,40,1,4,13,-9
2008,1452,75,1112,65,1,7,10,-3
2008,1458,71,1168,56,1,3,14,-11
2008,1462,73,1208,61,1,3,14,-11
2008,1116,86,1231,72,1,9,8,1
2008,1139,81,1375,61,1,7,10,-3
2008,1172,82,1211,76,1,10,7,3
2008,1207,66,1420,47,1,2,15,-13
2008,1257,79,1129,61,1,3,14,-11
2008,1272,87,1426,63,1,1,16,-15
2008,1274,78,1388,64,1,7,10,-3
2008,1280,76,1332,69,1,8,9,-1
2008,1314,113,1291,74,1,1,16,-15
2008,1328,72,1386,64,1,6,11,-5
2008,1360,70,1163,69,1,13,4,9
2008,1373,83,1435,62,1,13,4,9
2008,1397,72,1110,57,1,2,15,-13
2008,1400,74,1122,54,1,2,15,-13
2008,1437,75,1155,69,1,12,5,7
2008,1443,101,1179,99,1,12,5,7
2008,1242,75,1424,56,1,1,8,-7
2008,1277,65,1338,54,1,5,4,1
2008,1390,82,1266,81,1,3,6,-3
2008,1417,51,1401,49,1,1,9,-8
2008,1450,61,1323,41,1,4,5,-1
2008,1452,73,1181,67,1,7,2,5
2008,1458,72,1243,55,1,3,11,-8
2008,1462,85,1345,78,1,3,6,-3
2008,1172,74,1207,70,1,10,2,8
2008,1257,78,1328,48,1,3,6,-3
2008,1272,77,1280,74,1,1,8,-7
2008,1314,108,1116,77,1,1,9,-8
2008,1397,76,1139,71,1,2,7,-5
2008,1400,75,1274,72,1,2,7,-5
2008,1437,84,1373,72,1,12,13,-1
2008,1443,72,1360,63,1,12,13,-1
2008,1257,79,1397,60,1,3,2,1
2008,1314,68,1450,47,1,1,4,-3
2008,1417,88,1443,78,1,1,12,-11
2008,1462,79,1452,75,1,3,7,-4
2008,1172,73,1458,56,1,10,3,7
2008,1242,72,1437,57,1,1,12,-11
2008,1272,92,1277,74,1,1,5,-4
2008,1400,82,1390,62,1,2,3,-1
2008,1314,83,1257,73,1,1,3,-2
2008,1417,76,1462,57,1,1,3,-2
2008,1242,59,1172,57,1,1,10,-9
2008,1272,85,1400,67,1,1,2,-1
2008,1242,84,1314,66,1,1,1,0
2008,1272,78,1417,63,1,1,1,0
2008,1242,75,1272,68,1,1,1,0
2009,1287,58,1106,43,1,16,16,0
2009,1163,103,1151,47,1,1,16,-15
2009,1181,86,1127,62,1,2,15,-13
2009,1211,77,1103,64,1,4,13,-9
2009,1261,75,1139,71,1,8,9,-1
2009,1268,84,1143,71,1,10,7,3
2009,1272,81,1169,70,1,2,15,-13
2009,1276,62,1155,59,1,10,7,3
2009,1314,101,1347,58,1,1,16,-15
2009,1328,82,1288,54,1,2,15,-13
2009,1345,61,1320,56,1,5,12,-7
2009,1400,76,1278,62,1,7,10,-3
2009,1401,79,1140,66,1,9,8,1
2009,1417,65,1433,64,1,6,11,-5
2009,1437,80,1110,67,1,3,14,-11
2009,1443,76,1228,72,1,12,5,7
2009,1449,71,1280,58,1,4,13,-9
2009,1112,84,1428,71,1,12,5,7
2009,1113,66,1396,57,1,6,11,-5
2009,1156,84,1448,69,1,13,4,9
2009,1173,68,1452,60,1,11,6,5
2009,1242,84,1295,74,1,3,14,-11
2009,1257,74,1287,54,1,1,16,-15
2009,1266,58,1429,57,1,6,11,-5
2009,1277,77,1352,62,1,2,15,-13
2009,1281,78,1165,59,1,3,14,-11
2009,1329,77,1397,75,1,8,9,-1
2009,1338,72,1190,62,1,1,16,-15
2009,1373,74,1326,72,1,9,8,1
2009,1393,59,1372,44,1,3,14,-11
2009,1425,72,1130,55,1,10,7,3
2009,1458,61,1199,59,1,12,5,7
2009,1462,77,1340,59,1,4,13,-9
2009,1163,92,1401,66,1,1,9,-8
2009,1181,74,1400,69,1,2,7,-5
2009,1211,83,1443,81,1,4,12,-8
2009,1272,89,1268,70,1,2,10,-8
2009,1314,84,1261,70,1,1,8,-7
2009,1328,73,1276,63,1,2,10,-8
2009,1345,76,1449,74,1,5,4,1
2009,1437,89,1417,69,1,3,6,-3
2009,1112,71,1156,57,1,12,13,-1
2009,1242,60,1173,43,1,3,11,-8
2009,1257,79,1373,72,1,1,9,-8
2009,1277,74,1425,69,1,2,10,-8
2009,1281,83,1266,79,1,3,6,-3
2009,1338,84,1329,76,1,1,8,-7
2009,1393,78,1113,67,1,3,6,-3
2009,1462,60,1458,49,1,4,12,-8
2009,1163,72,1345,60,1,1,5,-4
2009,1281,102,1272,91,1,3,2,1
2009,1338,60,1462,55,1,1,4,-3
2009,1437,77,1181,54,1,3,2,1
2009,1257,103,1112,64,1,1,12,-11
2009,1277,67,1242,62,1,2,3,-1
2009,1314,98,1211,77,1,1,4,-3
2009,1328,84,1393,71,1,2,3,-1
2009,1163,82,1281,75,1,1,3,-2
2009,1437,78,1338,76,1,3,1,2
2009,1277,64,1257,52,1,2,1,1
2009,1314,72,1328,60,1,1,2,-1
2009,1277,82,1163,73,1,2,1,1
2009,1314,83,1437,69,1,1,3,-2
2009,1314,89,1277,72,1,1,2,-1
2010,1115,61,1457,44,1,16,16,0
2010,1124,68,1358,59,1,3,14,-11
2010,1139,77,1431,59,1,5,12,-7
2010,1140,99,1196,92,1,7,10,-3
2010,1242,90,1250,74,1,1,16,-15
2010,1243,82,1317,62,1,2,15,-13
2010,1246,100,1190,71,1,1,16,-15
2010,1293,66,1435,65,1,13,4,9
2010,1307,62,1285,57,1,3,14,-11
2010,1320,69,1424,66,1,9,8,1
2010,1325,97,1207,83,1,14,3,11
2010,1330,51,1323,50,1,11,6,5
2010,1388,80,1350,71,1,10,7,3
2010,1397,62,1361,59,1,6,11,-5
2010,1437,73,1352,70,1,2,15,-13
2010,1448,81,1400,80,1,9,8,1
2010,1449,80,1266,78,1,11,6,5
2010,1143,77,1257,62,1,8,9,-1
2010,1165,78,1396,65,1,12,5,7
2010,1181,73,1115,44,1,1,16,-15
2010,1210,64,1329,59,1,10,7,3
2010,1211,67,1199,60,1,8,9,-1
2010,1268,89,1222,77,1,4,13,-9
2010,1277,70,1308,67,1,5,12,-7
2010,1281,86,1155,78,1,10,7,3
2010,1326,68,1364,51,1,2,15,-13
2010,1338,89,1324,66,1,3,14,-11
2010,1345,72,1373,64,1,4,13,-9
2010,1393,79,1436,56,1,1,16,-15
2010,1401,69,1429,53,1,5,12,-7
2010,1452,77,1288,50,1,2,15,-13
2010,1458,53,1459,49,1,4,13,-9
2010,1462,65,1278,54,1,6,11,-5
2010,1124,76,1330,68,1,3,11,-8
2010,1139,54,1293,52,1,5,13,-8
2010,1243,84,1140,72,1,2,7,-5
2010,1246,90,1448,60,1,1,9,-8
2010,1320,69,1242,67,1,9,1,8
2010,1388,75,1437,68,1,10,2,8
2010,1397,83,1325,68,1,6,14,-8
2010,1449,82,1307,64,1,11,3,8
2010,1165,87,1458,69,1,12,4,8
2010,1181,68,1143,53,1,1,8,-7
2010,1277,85,1268,83,1,5,4,1
2010,1326,75,1210,66,1,2,10,-8
2010,1345,63,1401,61,1,4,5,-1
2010,1393,87,1211,65,1,1,8,-7
2010,1452,68,1281,59,1,2,10,-8
2010,1462,71,1338,68,1,6,3,3
2010,1139,63,1393,59,1,5,1,4
2010,1243,101,1462,96,1,2,6,-4
2010,1246,62,1165,45,1,1,12,-11
2010,1452,69,1449,56,1,2,11,-9
2010,1124,72,1388,49,1,3,10,-7
2010,1181,70,1345,57,1,1,4,-3
2010,1277,59,1320,52,1,5,9,-4
2010,1397,76,1326,73,1,6,2,4
2010,1139,63,1243,56,1,5,2,3
2010,1452,73,1246,66,1,2,1,1
2010,1181,78,1124,71,1,1,3,-2
2010,1277,70,1397,69,1,5,6,-1
2010,1139,52,1277,50,1,5,5,0
2010,1181,78,1452,57,1,1,2,-1
2010,1181,61,1139,59,1,1,5,-4
2011,1155,70,1412,52,1,12,12,0
2011,1421,81,1114,77,1,16,16,0
2011,1427,70,1106,61,1,16,16,0
2011,1433,59,1425,46,1,11,11,0
2011,1139,60,1330,58,1,8,9,-1
2011,1140,74,1459,66,1,3,14,-11
2011,1153,78,1281,63,1,6,11,-5
2011,1163,81,1137,52,1,3,14,-11
2011,1196,79,1364,51,1,2,15,-13
2011,1211,86,1385,71,1,11,6,5
2011,1243,73,1429,68,1,5,12,-7
2011,1246,59,1343,57,1,4,13,-9
2011,1287,62,1257,61,1,13,4,9
2011,1338,74,1421,51,1,1,16,-15
2011,1350,69,1435,66,1,12,5,7
2011,1361,68,1294,50,1,2,15,-13
2011,1396,66,1336,64,1,7,10,-3
2011,1417,78,1277,76,1,7,10,-3
2011,1452,84,1155,76,1,5,12,-7
2011,1458,72,1125,58,1,4,13,-9
2011,1112,77,1272,75,1,5,12,-7
2011,1181,87,1214,45,1,1,16,-15
2011,1199,57,1401,50,1,10,7,3
2011,1206,61,1437,57,1,8,9,-1
2011,1228,73,1424,62,1,9,8,1
2011,1242,72,1131,53,1,1,16,-15
2011,1266,66,1462,55,1,11,6,5
2011,1276,75,1397,45,1,8,9,-1
2011,1314,102,1254,87,1,2,15,-13
2011,1323,69,1103,56,1,2,15,-13
2011,1326,75,1427,46,1,1,16,-15
2011,1345,65,1389,43,1,3,14,-11
2011,1393,77,1232,60,1,3,14,-11
2011,1400,85,1324,81,1,4,13,-9
2011,1433,74,1207,56,1,11,6,5
2011,1449,68,1208,65,1,7,10,-3
2011,1139,71,1338,70,1,8,1,7
2011,1140,89,1211,67,1,3,11,-8
2011,1163,69,1153,58,1,3,6,-3
2011,1196,73,1417,65,1,2,7,-5
2011,1246,71,1452,63,1,4,5,-1
2011,1350,65,1287,48,1,12,13,-1
2011,1361,71,1396,64,1,2,7,-5
2011,1458,70,1243,65,1,4,5,-1
2011,1112,70,1400,69,1,5,4,1
2011,1181,73,1276,71,1,1,8,-7
2011,1199,71,1323,57,1,10,2,8
2011,1242,73,1228,59,1,1,9,-8
2011,1266,66,1393,62,1,11,3,8
2011,1314,86,1449,83,1,2,7,-5
2011,1326,98,1206,66,1,1,8,-7
2011,1433,94,1345,76,1,11,3,8
2011,1112,93,1181,77,1,5,1,4
2011,1139,61,1458,54,1,8,4,4
2011,1163,74,1361,67,1,3,2,1
2011,1196,83,1140,74,1,2,3,-1
2011,1242,77,1350,57,1,1,12,-11
2011,1246,62,1326,60,1,4,1,3
2011,1314,81,1266,63,1,2,11,-9
2011,1433,72,1199,71,1,11,10,1
2011,1139,74,1196,71,1,8,2,6
2011,1163,65,1112,63,1,3,5,-2
2011,1246,76,1314,69,1,4,2,2
2011,1433,71,1242,61,1,11,1,10
2011,1139,70,1433,62,1,8,11,-3
2011,1163,56,1246,55,1,3,4,-1
2011,1163,53,1139,41,1,3,8,-5
2012,1140,78,1233,72,1,14,14,0
2012,1443,59,1290,58,1,16,16,0
2012,1378,65,1143,54,1,12,12,0
2012,1436,71,1249,59,1,16,16,0
2012,1124,68,1355,60,1,3,14,-11
2012,1160,68,1424,64,1,11,6,5
2012,1211,77,1452,54,1,7,10,-3
2012,1231,79,1308,66,1,4,13,-9
2012,1235,77,1163,64,1,8,9,-1
2012,1243,70,1379,64,1,8,9,-1
2012,1246,81,1443,66,1,1,16,-15
2012,1257,69,1172,62,1,4,13,-9
2012,1266,88,1140,68,1,3,14,-11
2012,1293,58,1161,41,1,6,11,-5
2012,1307,75,1253,68,1,5,12,-7
2012,1326,78,1259,59,1,2,15,-13
2012,1393,72,1421,65,1,1,16,-15
2012,1433,62,1455,59,1,12,5,7
2012,1435,79,1217,70,1,5,12,-7
2012,1458,73,1285,49,1,4,13,-9
2012,1153,65,1400,59,1,6,11,-5
2012,1166,58,1104,57,1,8,9,-1
2012,1196,71,1438,45,1,7,10,-3
2012,1199,66,1382,63,1,3,14,-11
2012,1207,74,1125,59,1,3,14,-11
2012,1242,65,1178,50,1,2,15,-13
2012,1250,75,1181,70,1,15,2,13
2012,1277,89,1254,67,1,1,16,-15
2012,1301,79,1361,65,1,11,6,5
2012,1313,86,1281,84,1,15,2,13
2012,1314,77,1436,58,1,1,16,-15
2012,1325,65,1276,60,1,13,4,9
2012,1345,72,1388,69,1,10,7,3
2012,1378,58,1396,44,1,12,5,7
2012,1387,61,1272,54,1,9,8,1
2012,1462,67,1323,63,1,10,7,3
2012,1124,80,1160,63,1,3,11,-8
2012,1231,63,1433,61,1,4,12,-8
2012,1246,87,1235,71,1,1,8,-7
2012,1257,59,1307,56,1,4,5,-1
2012,1266,62,1293,53,1,3,6,-3
2012,1326,73,1211,66,1,2,7,-5
2012,1393,75,1243,59,1,1,8,-7
2012,1458,60,1435,57,1,4,5,-1
2012,1153,62,1199,56,1,6,3,3
2012,1196,84,1313,50,1,7,15,-8
2012,1242,63,1345,60,1,2,10,-8
2012,1277,65,1387,61,1,1,9,-8
2012,1301,66,1207,63,1,11,3,8
2012,1314,87,1166,73,1,1,8,-7
2012,1325,62,1378,56,1,13,12,1
2012,1462,70,1250,58,1,10,15,-5
2012,1196,68,1266,58,1,7,3,4
2012,1257,57,1277,44,1,4,1,3
2012,1326,81,1153,66,1,2,6,-4
2012,1393,64,1458,63,1,1,4,-3
2012,1124,75,1462,70,1,3,10,-7
2012,1242,60,1301,57,1,2,11,-9
2012,1246,102,1231,90,1,1,4,-3
2012,1314,73,1325,65,1,1,13,-12
2012,1257,72,1196,68,1,4,7,-3
2012,1326,77,1393,70,1,2,1,1
2012,1242,80,1314,67,1,2,1,1
2012,1246,82,1124,70,1,1,3,-2
2012,1242,64,1326,62,1,2,2,0
2012,1246,69,1257,61,1,1,4,-3
2012,1246,67,1242,59,1,1,2,-1
2013,1299,73,1251,72,1,16,16,0
2013,1388,67,1292,54,1,11,11,0
2013,1241,68,1254,55,1,16,16,0
2013,1247,80,1129,71,1,13,13,0
2013,1112,81,1125,64,1,6,11,-5
2013,1139,68,1137,56,1,6,11,-5
2013,1143,64,1424,61,1,12,5,7
2013,1161,84,1281,72,1,8,9,-1
2013,1211,64,1380,58,1,1,16,-15
2013,1217,68,1307,62,1,14,3,11
2013,1257,79,1299,48,1,1,16,-15
2013,1266,59,1172,58,1,3,14,-11
2013,1272,54,1388,52,1,6,11,-5
2013,1276,71,1355,56,1,4,13,-9
2013,1277,65,1434,54,1,3,14,-11
2013,1332,68,1329,55,1,12,5,7
2013,1387,64,1308,44,1,4,13,-9
2013,1393,81,1285,34,1,4,13,-9
2013,1433,88,1103,42,1,5,12,-7
2013,1455,73,1338,55,1,9,8,1
2013,1166,67,1153,63,1,7,10,-3
2013,1181,73,1107,61,1,2,15,-13
2013,1195,78,1207,68,1,15,2,13
2013,1196,79,1322,47,1,3,14,-11
2013,1228,57,1160,49,1,7,10,-3
2013,1231,83,1241,62,1,1,16,-15
2013,1235,76,1323,58,1,10,7,3
2013,1242,64,1443,57,1,1,16,-15
2013,1247,63,1243,61,1,13,4,9
2013,1274,78,1334,49,1,2,15,-13
2013,1278,83,1417,63,1,11,6,5
2013,1279,57,1458,46,1,12,5,7
2013,1314,78,1437,71,1,8,9,-1
2013,1326,95,1233,70,1,2,15,-13
2013,1361,70,1328,55,1,7,10,-3
2013,1396,76,1301,72,1,9,8,1
2013,1112,74,1217,51,1,6,14,-8
2013,1257,82,1161,56,1,1,8,-7
2013,1266,74,1139,72,1,3,6,-3
2013,1276,78,1433,53,1,4,5,-1
2013,1277,70,1272,48,1,3,6,-3
2013,1332,74,1387,57,1,12,4,8
2013,1393,66,1143,60,1,4,12,-8
2013,1455,76,1211,70,1,9,1,8
2013,1181,66,1166,50,1,2,7,-5
2013,1195,81,1361,71,1,15,7,8
2013,1196,78,1278,64,1,3,11,-8
2013,1231,58,1396,52,1,1,9,-8
2013,1242,70,1314,58,1,1,8,-7
2013,1247,76,1279,74,1,13,12,1
2013,1274,63,1228,59,1,2,7,-5
2013,1326,78,1235,75,1,2,10,-8
2013,1266,71,1274,61,1,3,2,1
2013,1326,73,1112,70,1,2,6,-4
2013,1393,61,1231,50,1,4,1,3
2013,1455,72,1247,58,1,9,13,-4
2013,1181,71,1277,61,1,2,3,-1
2013,1196,62,1195,50,1,3,15,-12
2013,1257,77,1332,69,1,1,12,-11
2013,1276,87,1242,85,1,4,1,3
2013,1393,55,1266,39,1,4,3,1
2013,1455,70,1326,66,1,9,2,7
2013,1257,85,1181,63,1,1,2,-1
2013,1276,79,1196,59,1,4,3,1
2013,1257,72,1455,68,1,1,9,-8
2013,1276,61,1393,56,1,4,4,0
2013,1257,82,1276,76,1,1,4,-3
2014,1107,71,1291,64,1,16,16,0
2014,1301,74,1462,59,1,12,12,0
2014,1142,81,1411,69,1,16,16,0
2014,1397,78,1234,65,1,11,11,0
2014,1163,89,1386,81,1,7,10,-3
2014,1173,60,1326,59,1,11,6,5
2014,1196,67,1107,55,1,1,16,-15
2014,1217,61,1153,57,1,12,5,7
2014,1257,71,1264,64,1,4,13,-9
2014,1276,57,1459,40,1,2,15,-13
2014,1277,93,1174,78,1,4,13,-9
2014,1295,80,1328,75,1,12,5,7
2014,1332,87,1140,68,1,7,10,-3
2014,1338,77,1160,48,1,9,8,1
2014,1361,73,1308,69,1,4,13,-9
2014,1387,83,1301,80,1,5,12,-7
2014,1393,77,1444,53,1,3,14,-11
2014,1400,87,1113,85,1,7,10,-3
2014,1437,73,1454,53,1,2,15,-13
2014,1458,75,1110,35,1,2,15,-13
2014,1112,68,1451,59,1,1,16,-15
2014,1124,74,1304,60,1,6,11,-5
2014,1166,76,1418,66,1,3,14,-11
2014,1211,85,1329,77,1,8,9,-1
2014,1235,93,1300,75,1,3,14,-11
2014,1242,80,1184,69,1,2,15,-13
2014,1246,56,1243,49,1,8,9,-1
2014,1272,71,1203,66,1,8,9,-1
2014,1273,78,1181,71,1,14,3,11
2014,1314,79,1344,77,1,6,11,-5
2014,1372,77,1433,75,1,12,5,7
2014,1390,58,1307,53,1,10,7,3
2014,1397,86,1269,67,1,11,6,5
2014,1417,76,1409,59,1,4,13,-9
2014,1438,70,1157,59,1,1,16,-15
2014,1455,64,1142,37,1,1,16,-15
2014,1163,77,1437,65,1,7,2,5
2014,1173,55,1393,53,1,11,3,8
2014,1196,61,1338,45,1,1,9,-8
2014,1257,66,1387,51,1,4,5,-1
2014,1276,79,1400,65,1,2,7,-5
2014,1277,80,1217,73,1,4,12,-8
2014,1361,63,1295,44,1,4,12,-8
2014,1458,85,1332,77,1,2,7,-5
2014,1112,84,1211,61,1,1,8,-7
2014,1124,85,1166,55,1,6,3,3
2014,1235,85,1314,83,1,3,6,-3
2014,1246,78,1455,76,1,8,1,7
2014,1390,60,1242,57,1,10,2,8
2014,1397,83,1273,63,1,11,14,-3
2014,1417,77,1372,60,1,4,12,-8
2014,1438,78,1272,60,1,1,8,-7
2014,1112,70,1361,64,1,1,4,-3
2014,1173,82,1390,72,1,11,10,1
2014,1196,79,1417,68,1,1,4,-3
2014,1458,69,1124,52,1,2,6,-4
2014,1163,81,1235,76,1,7,3,4
2014,1246,74,1257,69,1,8,4,4
2014,1276,73,1397,71,1,2,11,-9
2014,1277,61,1438,59,1,4,1,3
2014,1196,62,1173,52,1,1,11,-10
2014,1458,64,1112,63,1,2,1,1
2014,1163,60,1277,54,1,7,4,3
2014,1246,75,1276,72,1,8,2,6
2014,1163,63,1196,53,1,7,1,6
2014,1246,74,1458,73,1,8,2,6
2014,1163,60,1246,54,1,7,8,-1
2015,1214,74,1264,64,1,16,16,0
2015,1279,94,1140,90,1,11,11,0
2015,1173,56,1129,55,1,11,11,0
2015,1352,81,1316,77,1,16,16,0
2015,1112,93,1411,72,1,2,15,-13
2015,1116,56,1459,53,1,5,12,-7
2015,1139,56,1400,48,1,6,11,-5
2015,1153,66,1345,65,1,8,9,-1
2015,1207,84,1186,74,1,4,13,-9
2015,1209,57,1124,56,1,14,3,11
2015,1246,79,1214,56,1,1,16,-15
2015,1301,66,1261,65,1,8,9,-1
2015,1314,67,1217,65,1,4,13,-9
2015,1323,69,1318,65,1,3,14,-11
2015,1326,75,1433,72,1,10,7,3
2015,1412,60,1235,59,1,14,3,11
2015,1417,60,1374,59,1,11,6,5
2015,1428,57,1372,50,1,5,12,-7
2015,1437,93,1248,52,1,1,16,-15
2015,1462,76,1279,57,1,6,11,-5
2015,1173,66,1344,53,1,11,6,5
2015,1181,85,1352,56,1,1,16,-15
2015,1211,86,1295,76,1,2,15,-13
2015,1234,83,1172,52,1,7,10,-3
2015,1242,75,1308,56,1,2,15,-13
2015,1257,57,1414,55,1,4,13,-9
2015,1268,65,1434,62,1,4,13,-9
2015,1277,70,1208,63,1,7,10,-3
2015,1320,71,1461,54,1,5,12,-7
2015,1328,69,1107,60,1,3,14,-11
2015,1332,79,1329,73,1,8,9,-1
2015,1361,76,1385,64,1,8,9,-1
2015,1438,79,1125,67,1,2,15,-13
2015,1452,68,1138,62,1,5,12,-7
2015,1455,81,1231,76,1,7,10,-3
2015,1458,86,1157,72,1,1,16,-15
2015,1112,73,1326,58,1,2,10,-8
2015,1246,64,1153,51,1,1,8,-7
2015,1301,71,1437,68,1,8,1,7
2015,1314,87,1116,78,1,4,5,-1
2015,1323,67,1139,64,1,3,6,-3
2015,1417,92,1412,75,1,11,14,-3
2015,1428,75,1207,64,1,5,4,1
2015,1462,75,1209,67,1,6,14,-8
2015,1181,68,1361,49,1,1,8,-7
2015,1211,87,1234,68,1,2,7,-5
2015,1257,66,1320,53,1,4,5,-1
2015,1277,60,1438,54,1,7,2,5
2015,1328,72,1173,66,1,3,11,-8
2015,1452,69,1268,59,1,5,4,1
2015,1455,78,1242,65,1,7,2,5
2015,1458,72,1332,65,1,1,8,-7
2015,1112,68,1462,60,1,2,6,-4
2015,1246,78,1452,39,1,1,5,-4
2015,1323,81,1455,70,1,3,7,-4
2015,1458,79,1314,72,1,1,4,-3
2015,1181,63,1428,57,1,1,5,-4
2015,1211,74,1417,62,1,2,11,-9
2015,1257,75,1301,65,1,4,8,-4
2015,1277,62,1328,58,1,7,3,4
2015,1246,68,1323,66,1,1,3,-2
2015,1458,85,1112,78,1,1,2,-1
2015,1181,66,1211,52,1,1,2,-1
2015,1277,76,1257,70,1,7,4,3
2015,1181,81,1277,61,1,1,7,-6
2015,1458,71,1246,64,1,1,1,0
2015,1181,68,1458,63,1,1,1,0
2016,1195,96,1192,65,1,16,16,0
2016,1455,70,1435,50,1,11,11,0
2016,1221,59,1380,55,1,16,16,0
2016,1276,67,1409,62,1,11,11,0
2016,1114,85,1345,83,1,12,5,7
2016,1139,71,1403,61,1,9,8,1
2016,1163,74,1160,67,1,9,8,1
2016,1181,93,1423,85,1,4,13,-9
2016,1211,68,1371,52,1,11,6,5
2016,1231,99,1151,74,1,5,12,-7
2016,1235,94,1233,81,1,4,13,-9
2016,1242,105,1122,79,1,1,16,-15
2016,1246,85,1392,57,1,4,13,-9
2016,1274,79,1138,72,1,3,14,-11
2016,1314,83,1195,67,1,1,16,-15
2016,1344,70,1425,69,1,9,8,1
2016,1428,80,1201,69,1,3,14,-11
2016,1438,81,1214,45,1,1,16,-15
2016,1455,65,1112,55,1,11,6,5
2016,1463,79,1124,75,1,12,5,7
2016,1218,77,1143,66,1,13,4,9
2016,1234,72,1396,70,1,7,10,-3
2016,1268,79,1355,74,1,5,12,-7
2016,1292,90,1277,81,1,15,2,13
2016,1320,75,1400,72,1,11,6,5
2016,1323,70,1276,63,1,6,11,-5
2016,1328,82,1167,68,1,2,15,-13
2016,1332,91,1221,52,1,1,16,-15
2016,1372,70,1452,56,1,14,3,11
2016,1386,78,1153,76,1,8,9,-1
2016,1393,70,1173,51,1,10,7,3
2016,1401,92,1453,65,1,3,14,-11
2016,1433,75,1333,67,1,10,7,3
2016,1437,86,1421,56,1,2,15,-13
2016,1458,47,1338,43,1,7,10,-3
2016,1462,71,1451,53,1,2,15,-13
2016,1181,71,1463,64,1,4,12,-8
2016,1211,82,1428,59,1,11,3,8
2016,1231,73,1246,67,1,5,4,1
2016,1235,78,1114,61,1,4,12,-8
2016,1242,73,1163,61,1,1,9,-8
2016,1274,65,1455,57,1,3,11,-8
2016,1314,85,1344,66,1,1,9,-8
2016,1438,77,1139,69,1,1,9,-8
2016,1268,73,1218,60,1,5,13,-8
2016,1323,76,1372,75,1,6,14,-8
2016,1328,85,1433,81,1,2,10,-8
2016,1332,69,1386,64,1,1,8,-7
2016,1393,75,1292,50,1,10,15,-5
2016,1401,92,1320,88,1,3,11,-8
2016,1437,87,1234,68,1,2,7,-5
2016,1458,66,1462,63,1,7,2,5
2016,1242,79,1268,63,1,1,5,-4
2016,1328,77,1401,63,1,2,3,-1
2016,1332,82,1181,68,1,1,4,-3
2016,1437,92,1274,69,1,2,3,-1
2016,1314,101,1231,86,1,1,5,-4
2016,1323,61,1458,56,1,6,7,-1
2016,1393,63,1211,60,1,10,11,-1
2016,1438,84,1235,71,1,1,4,-3
2016,1328,80,1332,68,1,2,1,1
2016,1437,64,1242,59,1,2,1,1
2016,1314,88,1323,74,1,1,6,-5
2016,1393,68,1438,62,1,10,1,9
2016,1314,83,1393,66,1,1,10,-9
2016,1437,95,1328,51,1,2,2,0
2016,1437,77,1314,74,1,2,1,1
2017,1243,95,1448,88,1,11,11,0
2017,1291,67,1309,66,1,16,16,0
2017,1413,67,1300,63,1,16,16,0
2017,1425,75,1344,71,1,11,11,0
2017,1112,100,1315,82,1,2,15,-13
2017,1139,76,1457,64,1,4,13,-9
2017,1196,80,1190,65,1,4,13,-9
2017,1199,86,1195,80,1,3,14,-11
2017,1211,66,1355,46,1,1,16,-15
2017,1235,84,1305,73,1,5,12,-7
2017,1292,81,1278,72,1,12,5,7
2017,1321,68,1435,66,1,8,9,-1
2017,1323,60,1343,58,1,5,12,-7
2017,1345,80,1436,70,1,4,13,-9
2017,1388,85,1433,77,1,7,10,-3
2017,1437,76,1291,56,1,1,16,-15
2017,1438,76,1423,71,1,5,12,-7
2017,1452,86,1137,80,1,4,13,-9
2017,1458,84,1439,74,1,8,9,-1
2017,1462,76,1268,65,1,11,6,5
2017,1116,77,1371,71,1,8,9,-1
2017,1124,91,1308,73,1,3,14,-11
2017,1153,75,1243,61,1,6,11,-5
2017,1181,87,1407,65,1,2,15,-13
2017,1242,100,1413,62,1,1,16,-15
2017,1246,79,1297,70,1,2,15,-13
2017,1257,78,1240,63,1,2,15,-13
2017,1276,92,1329,91,1,7,10,-3
2017,1277,78,1274,58,1,9,8,1
2017,1314,103,1411,64,1,1,16,-15
2017,1332,93,1233,77,1,3,14,-11
2017,1348,84,1166,72,1,11,6,5
2017,1376,93,1266,73,1,7,10,-3
2017,1417,97,1245,80,1,3,14,-11
2017,1425,66,1374,65,1,11,6,5
2017,1455,64,1173,58,1,10,7,3
2017,1112,69,1388,60,1,2,7,-5
2017,1139,74,1292,65,1,4,12,-8
2017,1196,65,1438,39,1,4,5,-1
2017,1211,79,1321,73,1,1,8,-7
2017,1345,80,1235,76,1,4,5,-1
2017,1452,83,1323,71,1,4,5,-1
2017,1458,65,1437,62,1,8,1,7
2017,1462,91,1199,66,1,11,3,8
2017,1124,82,1425,78,1,3,11,-8
2017,1242,90,1277,70,1,1,9,-8
2017,1246,65,1455,62,1,2,10,-8
2017,1276,73,1257,69,1,7,2,5
2017,1314,72,1116,65,1,1,8,-7
2017,1332,75,1348,72,1,3,11,-8
2017,1376,88,1181,81,1,7,2,5
2017,1417,79,1153,67,1,3,6,-3
2017,1211,61,1452,58,1,1,4,-3
2017,1242,98,1345,66,1,1,4,-3
2017,1332,69,1276,68,1,3,7,-4
2017,1462,73,1112,71,1,11,2,9
2017,1196,84,1458,83,1,4,8,-4
2017,1246,86,1417,75,1,2,3,-1
2017,1314,92,1139,80,1,1,4,-3
2017,1376,70,1124,50,1,7,3,4
2017,1211,83,1462,59,1,1,11,-10
2017,1332,74,1242,60,1,3,1,2
2017,1314,75,1246,73,1,1,2,-1
2017,1376,77,1196,70,1,7,4,3
2017,1211,77,1376,73,1,1,7,-6
2017,1314,77,1332,76,1,1,3,-2
2017,1314,71,1211,65,1,1,1,0
2018,1347,71,1254,61,1,16,16,0
2018,1382,65,1417,58,1,11,11,0
2018,1393,60,1113,56,1,11,11,0
2018,1411,64,1300,46,1,16,16,0
2018,1104,86,1439,83,1,9,8,1
2018,1138,89,1112,68,1,13,4,9
2018,1181,89,1233,67,1,2,15,-13
2018,1196,77,1382,62,1,6,11,-5
2018,1211,68,1422,64,1,4,13,-9
2018,1222,67,1361,65,1,6,11,-5
2018,1242,76,1335,60,1,1,16,-15
2018,1246,78,1172,73,1,5,12,-7
2018,1260,64,1274,62,1,11,6,5
2018,1276,61,1285,47,1,3,14,-11
2018,1326,81,1355,73,1,5,12,-7
2018,1348,83,1328,78,1,7,10,-3
2018,1371,94,1301,83,1,8,9,-1
2018,1397,73,1460,47,1,3,14,-11
2018,1403,70,1372,60,1,3,14,-11
2018,1437,87,1347,61,1,1,16,-15
2018,1120,62,1158,58,1,4,13,-9
2018,1139,79,1116,62,1,10,7,3
2018,1153,68,1209,53,1,2,15,-13
2018,1155,79,1308,68,1,5,12,-7
2018,1199,67,1281,54,1,9,8,1
2018,1243,69,1166,59,1,9,8,1
2018,1267,81,1455,75,1,13,4,9
2018,1277,82,1137,78,1,3,14,-11
2018,1305,87,1400,83,1,7,10,-3
2018,1314,84,1252,66,1,2,15,-13
2018,1345,74,1168,48,1,2,15,-13
2018,1393,57,1395,52,1,11,6,5
2018,1401,73,1344,69,1,7,10,-3
2018,1420,74,1438,54,1,16,1,15
2018,1452,85,1293,68,1,5,12,-7
2018,1462,102,1411,83,1,1,16,-15
2018,1181,87,1348,62,1,2,7,-5
2018,1211,90,1326,84,1,4,5,-1
2018,1242,83,1371,79,1,1,8,-7
2018,1246,95,1138,75,1,5,13,-8
2018,1260,63,1397,62,1,11,3,8
2018,1276,64,1222,63,1,3,6,-3
2018,1403,69,1196,66,1,3,6,-3
2018,1437,81,1104,58,1,1,9,-8
2018,1155,84,1120,53,1,5,4,1
2018,1199,75,1462,70,1,9,1,8
2018,1243,50,1420,43,1,9,16,-7
2018,1305,75,1153,73,1,7,2,5
2018,1345,76,1139,73,1,2,10,-8
2018,1393,55,1277,53,1,11,3,8
2018,1401,86,1314,65,1,7,2,5
2018,1452,94,1267,71,1,5,13,-8
2018,1199,75,1211,60,1,9,4,5
2018,1243,61,1246,58,1,9,5,4
2018,1260,69,1305,68,1,11,7,4
2018,1276,99,1401,72,1,3,7,-4
2018,1181,69,1393,65,1,2,11,-9
2018,1242,80,1155,76,1,1,5,-4
2018,1403,78,1345,65,1,3,2,1
2018,1437,90,1452,78,1,1,5,-4
2018,1260,78,1243,62,1,11,9,2
2018,1276,58,1199,54,1,3,9,-6
2018,1242,85,1181,81,1,1,2,-1
2018,1437,71,1403,59,1,1,3,-2
2018,1276,69,1260,57,1,3,11,-8
2018,1437,95,1242,79,1,1,1,0
2018,1437,79,1276,62,1,1,3,-2
2019,1125,81,1396,70,1,11,11,0
2019,1192,82,1341,76,1,16,16,0
2019,1113,74,1385,65,1,11,11,0
2019,1295,78,1300,74,1,16,16,0
2019,1120,78,1308,77,1,5,12,-7
2019,1124,78,1393,69,1,9,8,1
2019,1196,70,1305,61,1,10,7,3
2019,1199,76,1436,69,1,4,13,-9
2019,1211,87,1192,49,1,1,16,-15
2019,1242,87,1318,53,1,4,13,-9
2019,1246,79,1101,44,1,2,15,-13
2019,1261,79,1463,74,1,3,14,-11
2019,1268,79,1125,77,1,6,11,-5
2019,1276,74,1285,55,1,2,15,-13
2019,1277,76,1133,65,1,2,15,-13
2019,1278,86,1257,76,1,10,7,3
2019,1293,83,1266,64,1,12,5,7
2019,1345,61,1330,48,1,3,14,-11
2019,1437,61,1388,57,1,6,11,-5
2019,1459,84,1371,68,1,7,10,-3
2019,1138,91,1113,74,1,6,11,-5
2019,1181,85,1295,62,1,1,16,-15
2019,1222,84,1209,55,1,3,14,-11
2019,1234,79,1153,72,1,10,7,3
2019,1251,80,1280,76,1,12,5,7
2019,1314,88,1233,73,1,1,16,-15
2019,1326,62,1235,59,1,11,6,5
2019,1328,95,1279,72,1,9,8,1
2019,1332,72,1458,54,1,12,5,7
2019,1397,77,1159,70,1,2,15,-13
2019,1403,72,1297,57,1,3,14,-11
2019,1414,70,1243,64,1,13,4,9
2019,1416,73,1433,58,1,9,8,1
2019,1438,71,1205,56,1,1,16,-15
2019,1439,66,1387,52,1,4,13,-9
2019,1449,78,1429,61,1,9,8,1
2019,1120,89,1242,75,1,5,4,1
2019,1199,90,1293,62,1,4,12,-8
2019,1211,83,1124,71,1,1,9,-8
2019,1246,62,1459,56,1,2,7,-5
2019,1261,69,1268,67,1,3,6,-3
2019,1276,64,1196,49,1,2,10,-8
2019,1277,70,1278,50,1,2,10,-8
2019,1345,87,1437,61,1,3,6,-3
2019,1181,77,1416,76,1,1,9,-8
2019,1222,74,1326,59,1,3,11,-8
2019,1314,81,1449,59,1,1,9,-8
2019,1332,73,1414,54,1,12,13,-1
2019,1397,83,1234,77,1,2,10,-8
2019,1403,78,1138,58,1,3,6,-3
2019,1438,63,1328,51,1,1,9,-8
2019,1439,67,1251,58,1,4,12,-8
2019,1211,72,1199,58,1,1,4,-3
2019,1345,99,1397,94,1,3,2,1
2019,1403,63,1276,44,1,3,2,1
2019,1438,53,1332,49,1,1,12,-11
2019,1120,97,1314,80,1,5,1,4
2019,1181,75,1439,73,1,1,4,-3
2019,1246,62,1222,58,1,2,3,-1
2019,1277,80,1261,63,1,2,3,-1
2019,1403,75,1211,69,1,3,1,2
2019,1438,80,1345,75,1,1,3,-2
2019,1120,77,1246,71,1,5,2,3
2019,1277,68,1181,67,1,2,1,1
2019,1403,61,1277,51,1,3,2,1
2019,1438,63,1120,62,1,1,5,-4
2019,1438,85,1403,77,1,1,3,-2
1985,1234,54,1116,63,0,8,9,-1
1985,1345,58,1120,59,0,6,11,-5
1985,1250,43,1207,68,0,16,1,15
1985,1425,55,1229,58,0,8,9,-1
1985,1325,38,1242,49,0,14,3,11
1985,1449,58,1246,66,0,5,12,-7
1985,1338,54,1256,78,0,12,5,7
1985,1233,58,1260,59,0,13,4,9
1985,1292,57,1314,76,0,15,2,13
1985,1333,70,1323,79,0,10,7,3
1985,1235,64,1326,75,0,13,4,9
1985,1299,83,1328,96,0,16,1,15
1985,1330,68,1374,85,0,12,5,7
1985,1380,59,1385,83,0,16,1,15
1985,1439,57,1396,60,0,9,8,1
1985,1361,80,1424,85,0,13,4,9
1985,1112,41,1104,50,0,10,7,3
1985,1403,53,1130,55,0,6,11,-5
1985,1337,62,1181,75,0,14,3,11
1985,1455,59,1208,67,0,11,6,5
1985,1273,58,1210,65,0,15,2,13
1985,1318,57,1228,76,0,14,3,11
1985,1275,68,1268,69,0,12,5,7
1985,1335,55,1272,67,0,15,2,13
1985,1192,55,1276,59,0,16,1,15
1985,1261,55,1298,78,0,4,13,-9
1985,1305,56,1301,65,0,14,3,11
1985,1177,65,1393,70,0,10,7,3
1985,1277,68,1412,70,0,10,7,3
1985,1409,75,1431,79,0,6,11,-5
1985,1267,65,1433,81,0,15,2,13
1985,1173,49,1437,51,0,9,8,1
1985,1242,64,1120,66,0,3,11,-8
1985,1396,46,1207,63,0,8,1,7
1985,1424,61,1246,64,0,4,12,-8
1985,1326,67,1256,79,0,4,5,-1
1985,1374,57,1260,70,0,5,4,1
1985,1323,58,1314,60,0,7,2,5
1985,1229,69,1328,75,0,9,1,8
1985,1116,65,1385,68,0,9,1,8
1985,1433,59,1104,63,0,2,7,-5
1985,1181,73,1130,74,0,3,11,-8
1985,1393,53,1210,70,0,7,2,5
1985,1208,58,1228,74,0,6,3,3
1985,1298,59,1268,64,0,13,5,8
1985,1412,66,1272,67,0,7,2,5
1985,1431,73,1301,86,0,11,3,8
1985,1276,55,1437,59,0,1,8,-7
1985,1260,53,1207,65,0,4,1,3
1985,1228,53,1210,61,0,3,2,1
1985,1130,57,1272,59,0,11,2,9
1985,1256,84,1328,86,0,5,1,4
1985,1104,55,1301,61,0,7,3,4
1985,1120,56,1314,62,0,11,2,9
1985,1246,70,1385,86,0,12,1,11
1985,1268,43,1437,46,0,5,8,-3
1985,1210,54,1207,60,0,2,1,1
1985,1328,61,1272,63,0,1,2,-1
1985,1301,60,1385,69,0,3,1,2
1985,1314,44,1437,56,0,2,8,-6
1985,1385,59,1207,77,0,1,1,0
1985,1272,45,1437,52,0,2,8,-6
1985,1207,64,1437,66,0,1,8,-7
1986,1431,65,1133,83,0,10,7,3
1986,1438,68,1177,72,0,5,12,-7
1986,1290,78,1181,85,0,16,1,15
1986,1403,64,1207,70,0,13,4,9
1986,1265,53,1210,68,0,15,2,13
1986,1299,46,1242,71,0,16,1,15
1986,1180,73,1257,93,0,15,2,13
1986,1345,87,1261,94,0,6,11,-5
1986,1123,63,1272,95,0,14,3,11
1986,1449,70,1277,72,0,12,5,7
1986,1428,72,1314,84,0,14,3,11
1986,1318,74,1328,80,0,13,4,9
1986,1452,64,1330,72,0,9,8,1
1986,1239,50,1396,61,0,8,9,-1
1986,1281,64,1412,66,0,11,6,5
1986,1439,62,1437,71,0,7,10,-3
1986,1462,80,1104,97,0,12,5,7
1986,1323,83,1114,90,0,3,14,-11
1986,1112,63,1120,73,0,9,8,1
1986,1231,79,1156,83,0,3,14,-11
1986,1193,51,1228,75,0,13,4,9
1986,1275,79,1235,81,0,10,7,3
1986,1172,55,1246,75,0,16,1,15
1986,1337,64,1268,69,0,12,5,7
1986,1103,64,1276,70,0,15,2,13
1986,1409,68,1298,87,0,10,7,3
1986,1234,64,1301,66,0,11,6,5
1986,1286,74,1385,83,0,16,1,15
1986,1350,59,1386,60,0,11,6,5
1986,1135,52,1393,101,0,15,2,13
1986,1419,51,1424,74,0,13,4,9
1986,1304,59,1443,67,0,9,8,1
1986,1328,69,1177,74,0,4,12,-8
1986,1330,61,1181,89,0,8,1,7
1986,1437,61,1210,66,0,10,2,8
1986,1396,43,1242,65,0,9,1,8
1986,1133,68,1257,82,0,7,2,5
1986,1272,81,1261,83,0,3,11,-8
1986,1207,68,1277,80,0,4,5,-1
1986,1412,59,1314,77,0,6,3,3
1986,1228,56,1104,58,0,4,5,-1
1986,1385,65,1120,81,0,1,8,-7
1986,1386,69,1156,75,0,6,14,-8
1986,1276,69,1235,72,0,2,7,-5
1986,1443,64,1246,71,0,8,1,7
1986,1393,85,1298,97,0,2,7,-5
1986,1114,66,1301,80,0,14,6,8
1986,1268,64,1424,70,0,5,4,1
1986,1424,63,1120,70,0,4,8,-4
1986,1104,63,1246,68,0,5,1,4
1986,1314,79,1257,94,0,3,2,1
1986,1210,64,1261,70,0,2,11,-9
1986,1177,67,1181,74,0,12,1,11
1986,1277,86,1242,96,0,5,1,4
1986,1156,70,1298,71,0,14,7,7
1986,1235,66,1301,70,0,7,6,1
1986,1120,76,1257,84,0,8,2,6
1986,1246,57,1261,59,0,1,11,-10
1986,1298,50,1181,71,0,7,1,6
1986,1301,67,1242,75,0,6,1,5
1986,1242,67,1181,71,0,1,1,0
1986,1261,77,1257,88,0,11,2,9
1986,1181,69,1257,72,0,1,2,-1
1987,1299,71,1104,88,0,15,2,13
1987,1360,61,1120,62,0,9,8,1
1987,1228,67,1122,68,0,3,14,-11
1987,1401,51,1181,58,0,12,5,7
1987,1193,58,1231,92,0,16,1,15
1987,1208,79,1243,82,0,8,9,-1
1987,1298,82,1276,97,0,8,9,-1
1987,1140,79,1309,83,0,10,7,3
1987,1335,82,1314,113,0,16,1,15
1987,1292,71,1323,84,0,12,5,7
1987,1412,68,1344,90,0,11,6,5
1987,1267,60,1395,76,0,13,4,9
1987,1141,73,1417,92,0,13,4,9
1987,1226,70,1424,95,0,16,1,15
1987,1438,60,1461,64,0,5,12,-7
1987,1281,69,1462,70,0,4,13,-9
1987,1256,62,1177,76,0,14,3,11
1987,1301,70,1196,82,0,11,6,5
1987,1137,53,1207,75,0,16,1,15
1987,1365,76,1234,99,0,15,2,13
1987,1222,55,1242,66,0,12,5,7
1987,1210,79,1261,85,0,7,10,-3
1987,1155,60,1283,65,0,4,13,-9
1987,1246,77,1326,91,0,8,9,-1
1987,1409,69,1328,74,0,11,6,5
1987,1265,68,1338,93,0,14,3,11
1987,1318,95,1345,104,0,14,3,11
1987,1455,55,1385,57,0,11,6,5
1987,1204,73,1393,79,0,15,2,13
1987,1380,56,1396,75,0,15,2,13
1987,1112,91,1431,98,0,10,7,3
1987,1452,62,1443,64,0,7,10,-3
1987,1309,76,1104,101,0,7,2,5
1987,1462,60,1181,65,0,13,5,8
1987,1120,90,1231,107,0,8,1,7
1987,1276,97,1314,109,0,9,1,8
1987,1395,57,1323,58,0,4,5,-1
1987,1122,87,1344,90,0,14,6,8
1987,1243,61,1424,80,0,9,1,8
1987,1417,68,1461,78,0,4,12,-8
1987,1385,75,1177,83,0,6,3,3
1987,1345,66,1196,85,0,3,6,-3
1987,1326,79,1207,82,0,9,1,8
1987,1431,82,1234,84,0,7,2,5
1987,1283,63,1242,67,0,13,5,8
1987,1396,62,1261,72,0,2,10,-8
1987,1338,93,1328,96,0,3,6,-3
1987,1443,86,1393,104,0,10,2,8
1987,1242,57,1207,70,0,5,1,4
1987,1323,68,1314,74,0,5,1,4
1987,1104,82,1344,103,0,2,6,-4
1987,1196,81,1393,87,0,6,2,4
1987,1181,82,1231,88,0,5,1,4
1987,1328,91,1234,93,0,6,2,4
1987,1177,58,1261,63,0,3,10,-7
1987,1461,78,1424,92,0,12,1,11
1987,1207,73,1344,88,0,1,6,-5
1987,1314,75,1393,79,0,1,2,-1
1987,1261,76,1231,77,0,10,1,9
1987,1234,81,1424,84,0,2,1,1
1987,1424,93,1231,97,0,1,1,0
1987,1344,63,1393,77,0,6,2,4
1987,1393,73,1231,74,0,2,1,1
1988,1133,86,1120,90,0,9,8,1
1988,1150,92,1140,98,0,13,4,9
1988,1455,62,1177,83,0,12,5,7
1988,1131,69,1181,85,0,15,2,13
1988,1385,59,1196,62,0,11,6,5
1988,1247,53,1243,66,0,13,4,9
1988,1333,61,1257,70,0,12,5,7
1988,1461,115,1258,119,0,7,10,-3
1988,1124,60,1272,75,0,8,9,-1
1988,1129,58,1276,63,0,14,3,11
1988,1317,65,1314,83,0,15,2,13
1988,1151,66,1328,94,0,16,1,15
1988,1192,79,1345,94,0,16,1,15
1988,1281,80,1348,87,0,6,11,-5
1988,1323,75,1374,83,0,10,7,3
1988,1299,55,1393,69,0,14,3,11
1988,1165,50,1112,90,0,16,1,15
1988,1261,63,1207,66,0,9,8,1
1988,1235,78,1210,90,0,12,5,7
1988,1427,72,1228,81,0,14,3,11
1988,1199,98,1234,102,0,12,5,7
1988,1462,72,1242,85,0,11,6,5
1988,1380,84,1246,99,0,15,2,13
1988,1364,82,1268,92,0,10,7,3
1988,1301,75,1293,78,0,3,14,-11
1988,1185,90,1338,108,0,15,2,13
1988,1231,69,1350,72,0,4,13,-9
1988,1431,64,1371,80,0,9,8,1
1988,1250,73,1396,87,0,16,1,15
1988,1283,50,1424,54,0,13,4,9
1988,1429,77,1435,80,0,10,7,3
1988,1116,74,1437,82,0,11,6,5
1988,1374,79,1181,94,0,7,2,5
1988,1177,58,1243,66,0,5,4,1
1988,1140,76,1257,97,0,4,5,-1
1988,1196,85,1276,108,0,6,3,3
1988,1258,97,1314,123,0,10,2,8
1988,1120,87,1328,107,0,8,1,7
1988,1272,73,1345,100,0,9,1,8
1988,1393,94,1348,97,0,3,11,-8
1988,1371,55,1112,84,0,8,1,7
1988,1424,86,1234,104,0,4,5,-1
1988,1293,58,1242,61,0,14,6,8
1988,1268,81,1246,90,0,7,2,5
1988,1210,55,1350,59,0,5,13,-8
1988,1207,53,1396,74,0,8,1,7
1988,1338,74,1435,80,0,2,7,-5
1988,1228,63,1437,66,0,3,6,-3
1988,1348,72,1181,73,0,11,2,9
1988,1257,98,1328,108,0,5,1,4
1988,1350,47,1396,69,0,13,1,12
1988,1246,74,1437,80,0,2,6,-4
1988,1234,79,1112,99,0,5,1,4
1988,1435,64,1242,77,0,7,6,1
1988,1345,70,1243,73,0,1,4,-3
1988,1276,69,1314,78,0,3,2,1
1988,1396,53,1181,63,0,1,2,-1
1988,1437,59,1328,78,0,6,1,5
1988,1314,52,1112,70,0,2,1,1
1988,1243,58,1242,71,0,4,6,-2
1988,1181,59,1242,66,0,2,6,-4
1988,1112,78,1328,86,0,1,1,0
1988,1328,79,1242,83,0,1,6,-5
1989,1352,60,1112,94,0,16,1,15
1989,1258,101,1116,120,0,12,5,7
1989,1338,64,1123,68,0,8,9,-1
1989,1388,70,1155,83,0,8,9,-1
1989,1272,63,1177,66,0,5,12,-7
1989,1354,69,1181,90,0,15,2,13
1989,1270,71,1228,77,0,16,1,15
1989,1247,74,1256,83,0,8,9,-1
1989,1114,71,1257,76,0,13,4,9
1989,1243,75,1278,86,0,6,11,-5
1989,1199,83,1292,97,0,4,13,-9
1989,1190,71,1328,72,0,16,1,15
1989,1390,78,1373,80,0,3,14,-11
1989,1225,56,1424,68,0,13,4,9
1989,1344,97,1438,100,0,12,5,7
1989,1397,68,1452,84,0,10,7,3
1989,1196,46,1161,68,0,7,10,-3
1989,1333,90,1191,94,0,6,11,-5
1989,1343,49,1207,50,0,16,1,15
1989,1206,85,1231,99,0,15,2,13
1989,1353,73,1234,87,0,13,4,9
1989,1462,87,1276,92,0,14,3,11
1989,1166,69,1281,85,0,14,3,11
1989,1376,66,1301,81,0,12,5,7
1989,1380,79,1314,93,0,15,2,13
1989,1435,65,1323,81,0,8,9,-1
1989,1283,51,1371,60,0,14,3,11
1989,1104,84,1375,86,0,6,11,-5
1989,1137,81,1393,104,0,15,2,13
1989,1210,70,1400,76,0,6,11,-5
1989,1235,74,1417,84,0,10,7,3
1989,1261,74,1431,85,0,10,7,3
1989,1155,68,1112,94,0,9,1,8
1989,1452,63,1181,70,0,7,2,5
1989,1123,60,1228,72,0,9,1,8
1989,1116,84,1257,93,0,5,4,1
1989,1373,67,1278,80,0,14,11,3
1989,1256,81,1328,124,0,9,1,8
1989,1177,70,1424,85,0,12,4,8
1989,1292,88,1438,104,0,13,5,8
1989,1323,74,1207,81,0,9,1,8
1989,1431,69,1231,92,0,7,2,5
1989,1375,82,1276,91,0,11,3,8
1989,1400,89,1281,108,0,11,3,8
1989,1234,96,1301,102,0,4,5,-1
1989,1417,81,1314,88,0,7,2,5
1989,1191,73,1371,87,0,11,3,8
1989,1161,50,1393,65,0,10,2,8
1989,1314,87,1276,92,0,2,3,-1
1989,1231,65,1371,78,0,2,3,-1
1989,1112,67,1424,68,0,1,4,-3
1989,1328,80,1438,86,0,1,5,-4
1989,1278,70,1181,87,0,11,2,9
1989,1301,61,1207,69,0,5,1,4
1989,1257,69,1228,83,0,4,1,3
1989,1281,80,1393,83,0,3,2,1
1989,1438,65,1276,102,0,5,3,2
1989,1424,61,1371,84,0,4,3,1
1989,1207,77,1181,85,0,1,2,-1
1989,1393,86,1228,89,0,2,1,1
1989,1228,81,1276,83,0,1,3,-2
1989,1181,78,1371,95,0,2,3,-1
1989,1371,79,1276,80,0,3,3,0
1990,1343,64,1116,68,0,13,4,9
1990,1333,53,1123,54,0,5,12,-7
1990,1231,63,1143,65,0,8,9,-1
1990,1140,47,1155,49,0,12,5,7
1990,1131,52,1163,76,0,16,1,15
1990,1228,86,1173,88,0,5,12,-7
1990,1190,83,1210,99,0,13,4,9
1990,1379,63,1247,79,0,13,4,9
1990,1225,59,1257,78,0,13,4,9
1990,1437,63,1261,70,0,12,5,7
1990,1293,71,1277,75,0,16,1,15
1990,1283,70,1314,83,0,9,8,1
1990,1344,83,1326,84,0,9,8,1
1990,1406,68,1328,77,0,16,1,15
1990,1222,66,1364,70,0,8,9,-1
1990,1114,72,1424,102,0,16,1,15
1990,1161,54,1104,71,0,10,7,3
1990,1378,67,1112,79,0,15,2,13
1990,1350,46,1181,81,0,14,3,11
1990,1411,52,1207,70,0,14,3,11
1990,1352,71,1242,79,0,15,2,13
1990,1308,92,1258,111,0,6,11,-5
1990,1229,70,1276,76,0,14,3,11
1990,1431,61,1278,64,0,11,6,5
1990,1281,71,1320,74,0,3,14,-11
1990,1419,63,1345,75,0,15,2,13
1990,1396,65,1385,81,0,11,6,5
1990,1164,48,1393,70,0,15,2,13
1990,1208,88,1400,100,0,7,10,-3
1990,1412,56,1417,68,0,10,7,3
1990,1323,67,1438,75,0,10,7,3
1990,1243,79,1462,87,0,11,6,5
1990,1173,84,1116,86,0,12,4,8
1990,1257,60,1123,62,0,4,12,-8
1990,1247,75,1155,79,0,4,5,-1
1990,1143,54,1163,74,0,9,1,8
1990,1261,91,1210,94,0,5,4,1
1990,1364,58,1277,62,0,9,1,8
1990,1328,77,1314,79,0,1,8,-7
1990,1326,65,1424,76,0,8,1,7
1990,1112,55,1104,77,0,2,7,-5
1990,1385,72,1181,76,0,6,3,3
1990,1276,115,1258,149,0,3,11,-8
1990,1320,78,1278,81,0,14,6,8
1990,1438,61,1393,63,0,7,2,5
1990,1345,72,1400,73,0,2,10,-8
1990,1242,70,1417,71,0,2,7,-5
1990,1207,71,1462,74,0,3,6,-3
1990,1314,73,1116,96,0,8,4,4
1990,1155,70,1163,71,0,5,1,4
1990,1417,81,1181,90,0,7,3,4
1990,1462,89,1400,102,0,6,10,-4
1990,1277,80,1210,81,0,1,4,-3
1990,1104,60,1258,62,0,7,11,-4
1990,1393,75,1278,82,0,2,6,-4
1990,1123,67,1424,69,0,12,1,11
1990,1400,85,1116,88,0,10,4,6
1990,1163,78,1181,79,0,1,3,-2
1990,1278,91,1210,93,0,6,4,2
1990,1258,101,1424,131,0,11,1,10
1990,1116,83,1181,97,0,4,3,1
1990,1210,81,1424,90,0,4,1,3
1990,1181,73,1424,103,0,3,1,2
1991,1384,80,1112,93,0,15,2,13
1991,1438,48,1140,61,0,7,10,-3
1991,1261,62,1163,79,0,6,11,-5
1991,1308,56,1166,64,0,6,11,-5
1991,1419,73,1181,102,0,15,2,13
1991,1425,72,1199,75,0,10,7,3
1991,1157,69,1231,79,0,15,2,13
1991,1190,73,1234,76,0,10,7,3
1991,1309,49,1242,55,0,14,3,11
1991,1379,85,1301,114,0,11,6,5
1991,1307,54,1329,67,0,14,3,11
1991,1208,68,1338,76,0,11,6,5
1991,1393,69,1350,73,0,2,15,-13
1991,1337,51,1371,71,0,14,3,11
1991,1345,63,1396,80,0,7,10,-3
1991,1304,84,1462,89,0,3,14,-11
1991,1293,79,1104,89,0,13,4,9
1991,1353,76,1113,79,0,9,8,1
1991,1209,76,1116,117,0,16,1,15
1991,1280,56,1185,76,0,5,12,-7
1991,1435,60,1207,70,0,9,8,1
1991,1177,70,1210,87,0,9,8,1
1991,1453,58,1277,60,0,12,5,7
1991,1318,66,1314,101,0,16,1,15
1991,1406,86,1326,97,0,16,1,15
1991,1417,69,1336,74,0,4,13,-9
1991,1296,68,1385,75,0,13,4,9
1991,1389,65,1400,73,0,12,5,7
1991,1285,65,1424,99,0,16,1,15
1991,1375,72,1428,82,0,13,4,9
1991,1343,48,1437,50,0,8,9,-1
1991,1256,65,1448,71,0,12,5,7
1991,1140,61,1112,76,0,10,2,8
1991,1462,50,1163,66,0,14,11,3
1991,1234,70,1181,85,0,7,2,5
1991,1199,60,1231,82,0,7,2,5
1991,1338,66,1242,77,0,6,3,3
1991,1301,64,1329,73,0,6,3,3
1991,1166,69,1371,81,0,11,3,8
1991,1350,64,1396,77,0,15,10,5
1991,1448,88,1104,96,0,5,4,1
1991,1113,90,1116,97,0,8,1,7
1991,1336,68,1185,71,0,13,12,1
1991,1437,69,1314,84,0,9,1,8
1991,1210,61,1326,65,0,8,1,7
1991,1400,76,1385,84,0,5,4,1
1991,1207,54,1424,62,0,8,1,7
1991,1277,84,1428,85,0,5,4,1
1991,1104,70,1116,93,0,4,1,3
1991,1231,65,1242,83,0,2,3,-1
1991,1112,77,1371,81,0,2,3,-1
1991,1428,66,1424,83,0,4,1,3
1991,1163,67,1181,81,0,11,2,9
1991,1185,67,1314,93,0,12,1,11
1991,1326,74,1385,91,0,1,4,-3
1991,1329,63,1396,72,0,3,10,-7
1991,1116,81,1242,93,0,1,3,-2
1991,1371,65,1424,77,0,3,1,2
1991,1385,61,1181,78,0,4,2,2
1991,1396,72,1314,75,0,10,1,9
1991,1424,77,1181,79,0,1,2,-1
1991,1314,73,1242,79,0,1,3,-2
1991,1242,65,1181,72,0,3,2,1
1992,1390,75,1104,80,0,12,5,7
1992,1293,69,1116,80,0,14,3,11
1992,1304,65,1163,86,0,8,9,-1
1992,1144,56,1181,82,0,16,1,15
1992,1285,68,1199,78,0,14,3,11
1992,1378,60,1207,75,0,11,6,5
1992,1222,60,1210,65,0,10,7,3
1992,1183,55,1231,94,0,15,2,13
1992,1400,92,1234,98,0,8,9,-1
1992,1140,83,1261,94,0,10,7,3
1992,1337,70,1272,80,0,11,6,5
1992,1452,78,1281,89,0,12,5,7
1992,1275,63,1314,68,0,13,4,9
1992,1290,56,1326,83,0,16,1,15
1992,1247,76,1371,78,0,13,4,9
1992,1419,54,1425,84,0,15,2,13
1992,1174,47,1153,85,0,13,4,9
1992,1112,80,1190,87,0,3,14,-11
1992,1150,74,1235,76,0,7,10,-3
1992,1224,67,1242,100,0,16,1,15
1992,1330,69,1246,88,0,15,2,13
1992,1448,58,1257,81,0,9,8,1
1992,1200,58,1269,85,0,14,3,11
1992,1396,66,1276,73,0,11,6,5
1992,1283,54,1277,61,0,12,5,7
1992,1177,73,1308,81,0,5,12,-7
1992,1204,73,1329,100,0,15,2,13
1992,1343,43,1393,51,0,11,6,5
1992,1385,57,1408,61,0,7,10,-3
1992,1352,53,1417,73,0,16,1,15
1992,1328,83,1418,87,0,4,13,-9
1992,1191,50,1431,55,0,8,9,-1
1992,1234,62,1181,75,0,9,1,8
1992,1207,68,1199,78,0,6,3,3
1992,1425,78,1210,79,0,2,7,-5
1992,1261,79,1231,89,0,7,2,5
1992,1116,80,1272,82,0,3,6,-3
1992,1104,55,1314,64,0,5,4,1
1992,1163,55,1326,78,0,9,1,8
1992,1281,71,1371,88,0,5,4,1
1992,1277,65,1153,77,0,5,4,1
1992,1235,98,1246,106,0,10,2,8
1992,1393,71,1269,77,0,6,3,3
1992,1190,90,1276,102,0,14,6,8
1992,1418,73,1308,81,0,13,12,1
1992,1408,71,1329,87,0,10,2,8
1992,1257,69,1417,85,0,8,1,7
1992,1242,60,1431,66,0,1,9,-8
1992,1371,69,1181,81,0,4,1,3
1992,1199,74,1231,85,0,3,2,1
1992,1269,77,1246,87,0,3,2,1
1992,1308,78,1417,85,0,12,1,11
1992,1431,67,1153,69,0,9,4,5
1992,1210,79,1272,83,0,7,6,1
1992,1329,72,1276,75,0,2,6,-4
1992,1314,73,1326,80,0,4,1,3
1992,1246,103,1181,104,0,2,1,1
1992,1417,79,1231,106,0,1,2,-1
1992,1272,57,1153,88,0,6,4,2
1992,1326,71,1276,75,0,1,6,-5
1992,1231,78,1181,81,0,2,1,1
1992,1153,72,1276,76,0,4,6,-2
1992,1276,51,1181,71,0,6,1,5
1993,1221,64,1116,94,0,13,4,9
1993,1374,71,1140,80,0,10,7,3
1993,1261,64,1143,66,0,11,6,5
1993,1356,70,1181,105,0,14,3,11
1993,1191,70,1199,82,0,14,3,11
1993,1253,72,1228,75,0,11,6,5
1993,1123,72,1242,94,0,15,2,13
1993,1187,65,1314,85,0,16,1,15
1993,1345,68,1348,74,0,9,8,1
1993,1112,61,1365,64,0,2,15,-13
1993,1398,59,1371,81,0,15,2,13
1993,1403,67,1385,85,0,12,5,7
1993,1281,61,1396,75,0,10,7,3
1993,1243,53,1408,55,0,6,11,-5
1993,1129,72,1435,92,0,14,3,11
1993,1272,52,1443,55,0,10,7,3
1993,1164,66,1153,93,0,15,2,13
1993,1307,68,1203,82,0,5,12,-7
1993,1460,54,1231,97,0,16,1,15
1993,1419,69,1234,82,0,13,4,9
1993,1351,52,1246,96,0,16,1,15
1993,1174,70,1257,76,0,13,4,9
1993,1335,50,1269,54,0,14,3,11
1993,1157,52,1276,84,0,16,1,15
1993,1304,79,1308,93,0,10,7,3
1993,1266,62,1329,74,0,12,5,7
1993,1210,78,1380,93,0,4,13,-9
1993,1235,70,1417,81,0,8,9,-1
1993,1338,65,1428,86,0,9,8,1
1993,1264,66,1438,78,0,11,6,5
1993,1151,58,1448,81,0,12,5,7
1993,1309,55,1462,73,0,8,9,-1
1993,1385,74,1116,80,0,5,4,1
1993,1181,77,1143,82,0,3,6,-3
1993,1408,63,1199,94,0,11,3,8
1993,1140,76,1242,90,0,7,2,5
1993,1348,67,1314,112,0,8,1,7
1993,1365,57,1396,68,0,15,7,8
1993,1228,68,1435,85,0,6,3,3
1993,1371,68,1443,72,0,2,7,-5
1993,1308,55,1153,92,0,7,2,5
1993,1380,80,1203,90,0,13,12,1
1993,1462,70,1231,73,0,9,1,8
1993,1428,62,1246,83,0,8,1,7
1993,1329,63,1257,78,0,5,4,1
1993,1417,84,1276,86,0,9,1,8
1993,1269,56,1438,71,0,3,6,-3
1993,1234,78,1448,84,0,4,5,-1
1993,1443,78,1199,81,0,7,3,4
1993,1257,69,1231,82,0,4,1,3
1993,1143,76,1242,93,0,6,2,4
1993,1448,69,1246,103,0,5,1,4
1993,1438,54,1153,71,0,6,2,4
1993,1203,64,1276,72,0,12,1,11
1993,1116,74,1314,80,0,4,1,3
1993,1435,59,1396,67,0,3,7,-4
1993,1231,77,1242,83,0,1,2,-1
1993,1199,81,1246,106,0,3,1,2
1993,1396,72,1276,77,0,7,1,6
1993,1153,68,1314,75,0,2,1,1
1993,1246,78,1276,81,0,1,1,0
1993,1242,68,1314,78,0,2,1,1
1993,1276,71,1314,77,0,1,1,0
1994,1344,70,1104,76,0,8,9,-1
1994,1351,46,1163,64,0,15,2,13
1994,1241,62,1196,64,0,14,3,11
1994,1412,46,1203,51,0,7,10,-3
1994,1151,73,1242,102,0,13,4,9
1994,1387,66,1268,74,0,7,10,-3
1994,1402,60,1269,78,0,15,2,13
1994,1337,74,1276,78,0,14,3,11
1994,1298,53,1281,76,0,16,1,15
1994,1304,80,1335,90,0,6,11,-5
1994,1416,67,1345,98,0,16,1,15
1994,1218,78,1393,92,0,13,4,9
1994,1443,77,1400,91,0,11,6,5
1994,1158,58,1448,68,0,12,5,7
1994,1143,57,1453,61,0,5,12,-7
1994,1153,72,1458,80,0,8,9,-1
1994,1259,55,1112,81,0,15,2,13
1994,1299,79,1116,94,0,16,1,15
1994,1450,64,1130,67,0,8,9,-1
1994,1411,70,1181,82,0,15,2,13
1994,1228,77,1207,84,0,8,9,-1
1994,1325,72,1231,84,0,12,5,7
1994,1398,70,1246,83,0,14,3,11
1994,1129,58,1257,67,0,14,3,11
1994,1418,59,1266,81,0,11,6,5
1994,1371,73,1277,84,0,10,7,3
1994,1356,60,1278,74,0,11,6,5
1994,1251,51,1314,71,0,16,1,15
1994,1308,55,1329,65,0,13,4,9
1994,1180,39,1396,61,0,13,4,9
1994,1417,102,1409,112,0,5,12,-7
1994,1307,54,1438,57,0,10,7,3
1994,1203,63,1163,75,0,10,2,8
1994,1335,58,1196,70,0,11,3,8
1994,1448,58,1242,69,0,5,4,1
1994,1269,87,1268,95,0,2,10,-8
1994,1400,79,1276,84,0,6,3,3
1994,1458,96,1281,109,0,9,1,8
1994,1104,73,1345,83,0,9,1,8
1994,1453,59,1393,64,0,12,4,8
1994,1438,58,1112,71,0,7,2,5
1994,1207,73,1116,85,0,9,1,8
1994,1314,72,1130,75,0,1,9,-8
1994,1277,74,1181,85,0,7,2,5
1994,1396,58,1231,67,0,4,5,-1
1994,1278,55,1257,60,0,6,3,3
1994,1246,63,1266,75,0,3,6,-3
1994,1329,80,1409,82,0,4,12,-8
1994,1257,70,1112,82,0,3,2,1
1994,1266,49,1181,59,0,6,2,4
1994,1393,88,1281,98,0,4,1,3
1994,1242,78,1345,83,0,4,1,3
1994,1409,84,1116,103,0,12,1,11
1994,1231,68,1130,77,0,5,9,-4
1994,1163,60,1196,69,0,2,3,-1
1994,1268,71,1276,78,0,10,3,7
1994,1281,72,1112,92,0,1,2,-1
1994,1345,60,1181,69,0,1,2,-1
1994,1276,68,1116,76,0,3,1,2
1994,1130,66,1196,74,0,9,3,6
1994,1112,82,1116,91,0,2,1,1
1994,1196,65,1181,70,0,3,2,1
1994,1181,72,1116,76,0,2,1,1
1995,1335,85,1104,91,0,12,5,7
1995,1123,66,1113,81,0,12,5,7
1995,1396,71,1153,77,0,10,7,3
1995,1151,71,1163,100,0,15,2,13
1995,1159,68,1242,82,0,16,1,15
1995,1291,67,1246,113,0,16,1,15
1995,1328,67,1264,77,0,4,13,-9
1995,1211,63,1268,87,0,14,3,11
1995,1112,62,1275,71,0,5,12,-7
1995,1180,49,1329,73,0,13,4,9
1995,1278,61,1387,64,0,8,9,-1
1995,1332,73,1400,90,0,6,11,-5
1995,1140,70,1408,76,0,8,9,-1
1995,1311,72,1438,96,0,13,4,9
1995,1276,76,1443,82,0,9,8,1
1995,1299,47,1448,79,0,16,1,15
1995,1411,78,1116,79,0,15,2,13
1995,1462,63,1207,68,0,11,6,5
1995,1196,61,1235,64,0,10,7,3
1995,1389,51,1269,68,0,15,2,13
1995,1257,56,1272,77,0,11,6,5
1995,1365,67,1280,75,0,12,5,7
1995,1231,60,1281,65,0,9,8,1
1995,1293,70,1314,80,0,15,2,13
1995,1437,81,1330,89,0,3,14,-11
1995,1453,48,1345,49,0,14,3,11
1995,1150,68,1390,70,0,7,10,-3
1995,1356,92,1393,96,0,10,7,3
1995,1228,62,1409,68,0,11,6,5
1995,1198,56,1417,92,0,16,1,15
1995,1253,64,1428,76,0,13,4,9
1995,1277,72,1451,79,0,3,14,-11
1995,1264,54,1113,64,0,13,5,8
1995,1153,91,1163,96,0,7,2,5
1995,1443,70,1242,75,0,8,1,7
1995,1408,60,1246,82,0,9,1,8
1995,1400,68,1268,82,0,11,3,8
1995,1104,52,1329,66,0,5,4,1
1995,1275,54,1438,60,0,12,4,8
1995,1387,59,1448,64,0,9,1,8
1995,1393,94,1116,96,0,7,2,5
1995,1451,51,1207,53,0,14,6,8
1995,1390,53,1269,75,0,10,2,8
1995,1345,73,1272,75,0,3,6,-3
1995,1428,64,1280,78,0,4,5,-1
1995,1235,51,1314,73,0,7,2,5
1995,1330,52,1409,64,0,14,6,8
1995,1281,74,1417,75,0,8,1,7
1995,1268,89,1163,99,0,3,2,1
1995,1113,73,1246,97,0,5,1,4
1995,1207,64,1314,74,0,6,2,4
1995,1280,67,1417,86,0,5,1,4
1995,1272,91,1116,96,0,6,2,4
1995,1409,51,1269,76,0,6,2,4
1995,1448,66,1329,71,0,1,4,-3
1995,1242,58,1438,67,0,1,4,-3
1995,1246,61,1314,74,0,1,2,-1
1995,1163,96,1417,102,0,2,1,1
1995,1438,61,1116,68,0,4,2,2
1995,1269,54,1329,68,0,2,4,-2
1995,1314,68,1116,75,0,2,2,0
1995,1329,61,1417,74,0,4,1,3
1995,1116,78,1417,89,0,2,1,1
1996,1336,80,1116,86,0,5,12,-7
1996,1159,59,1163,68,0,16,1,15
1996,1272,63,1180,75,0,5,12,-7
1996,1181,60,1185,75,0,8,9,-1
1996,1155,74,1208,81,0,9,8,1
1996,1143,64,1235,74,0,12,5,7
1996,1363,72,1246,110,0,16,1,15
1996,1284,44,1266,68,0,13,4,9
1996,1416,70,1269,92,0,16,1,15
1996,1433,51,1280,58,0,12,5,7
1996,1417,41,1343,43,0,4,13,-9
1996,1441,71,1345,73,0,16,1,15
1996,1133,58,1390,66,0,8,9,-1
1996,1286,55,1393,88,0,13,4,9
1996,1145,43,1428,72,0,13,4,9
1996,1453,48,1439,61,0,8,9,-1
1996,1434,51,1112,90,0,14,3,11
1996,1231,51,1130,64,0,6,11,-5
1996,1422,61,1153,66,0,15,2,13
1996,1290,56,1207,93,0,15,2,13
1996,1122,79,1210,90,0,14,3,11
1996,1203,79,1234,81,0,11,6,5
1996,1354,54,1242,92,0,15,2,13
1996,1409,80,1257,82,0,11,6,5
1996,1243,48,1307,69,0,10,7,3
1996,1309,62,1314,83,0,11,6,5
1996,1268,79,1365,91,0,7,10,-3
1996,1328,43,1396,61,0,10,7,3
1996,1276,76,1400,80,0,7,10,-3
1996,1296,73,1403,74,0,14,3,11
1996,1339,58,1437,92,0,14,3,11
1996,1419,50,1448,62,0,15,2,13
1996,1266,56,1116,65,0,4,12,-8
1996,1185,81,1163,95,0,9,1,8
1996,1345,69,1208,76,0,1,8,-7
1996,1439,60,1246,84,0,9,1,8
1996,1390,74,1269,79,0,9,1,8
1996,1343,41,1280,63,0,13,5,8
1996,1180,58,1393,69,0,12,4,8
1996,1235,67,1428,73,0,5,4,1
1996,1234,73,1112,87,0,6,3,3
1996,1396,65,1153,78,0,7,2,5
1996,1307,62,1207,73,0,7,2,5
1996,1130,89,1210,103,0,11,3,8
1996,1365,51,1242,76,0,10,2,8
1996,1437,64,1257,68,0,3,6,-3
1996,1314,73,1403,92,0,6,3,3
1996,1400,62,1448,65,0,10,2,8
1996,1403,90,1207,98,0,3,2,1
1996,1428,70,1246,101,0,4,1,3
1996,1116,63,1269,79,0,12,1,11
1996,1257,59,1448,60,0,6,2,4
1996,1210,70,1153,87,0,3,2,1
1996,1112,80,1242,83,0,3,2,1
1996,1163,55,1280,60,0,1,5,-4
1996,1208,81,1393,83,0,8,4,4
1996,1448,63,1246,83,0,2,1,1
1996,1207,62,1269,86,0,2,1,1
1996,1153,63,1280,73,0,2,5,-3
1996,1242,57,1393,60,0,2,4,-2
1996,1269,74,1246,81,0,1,1,0
1996,1280,69,1393,77,0,5,4,1
1996,1393,67,1246,76,0,4,1,3
1997,1375,57,1112,65,0,13,4,9
1997,1434,66,1130,73,0,12,5,7
1997,1343,52,1143,55,0,12,5,7
1997,1139,69,1153,86,0,14,3,11
1997,1268,66,1158,75,0,5,12,-7
1997,1231,62,1160,80,0,8,9,-1
1997,1438,60,1234,73,0,9,8,1
1997,1229,57,1235,69,0,11,6,5
1997,1238,64,1242,78,0,16,1,15
1997,1285,54,1246,92,0,16,1,15
1997,1193,74,1314,82,0,16,1,15
1997,1348,76,1345,83,0,9,8,1
1997,1334,65,1386,75,0,13,4,9
1997,1149,75,1417,109,0,15,2,13
1997,1254,91,1437,101,0,13,4,9
1997,1435,68,1462,80,0,10,7,3
1997,1207,67,1150,79,0,10,7,3
1997,1208,70,1151,73,0,3,14,-11
1997,1275,56,1155,68,0,13,4,9
1997,1376,65,1164,78,0,2,15,-13
1997,1293,68,1181,71,0,15,2,13
1997,1425,77,1228,90,0,11,6,5
1997,1269,57,1257,65,0,11,6,5
1997,1402,46,1278,78,0,16,1,15
1997,1330,55,1307,59,0,14,3,11
1997,1266,59,1344,81,0,7,10,-3
1997,1328,67,1390,80,0,11,6,5
1997,1279,40,1396,62,0,8,9,-1
1997,1458,58,1400,71,0,7,10,-3
1997,1131,52,1409,81,0,12,5,7
1997,1298,61,1428,75,0,15,2,13
1997,1388,46,1448,68,0,14,3,11
1997,1158,69,1112,73,0,12,4,8
1997,1437,68,1143,75,0,4,5,-1
1997,1153,66,1235,67,0,3,6,-3
1997,1345,61,1242,75,0,8,1,7
1997,1234,69,1246,75,0,8,1,7
1997,1160,56,1314,73,0,9,1,8
1997,1130,77,1386,81,0,5,4,1
1997,1462,83,1417,96,0,7,2,5
1997,1228,63,1151,75,0,6,14,-8
1997,1409,59,1155,65,0,5,4,1
1997,1307,63,1257,64,0,3,6,-3
1997,1396,57,1278,76,0,9,1,8
1997,1181,87,1344,98,0,2,10,-8
1997,1448,66,1390,72,0,3,6,-3
1997,1164,81,1400,82,0,15,10,5
1997,1150,58,1428,77,0,7,2,5
1997,1386,68,1246,83,0,4,1,3
1997,1155,84,1278,90,0,4,1,3
1997,1235,73,1417,74,0,6,2,4
1997,1390,77,1428,82,0,6,2,4
1997,1242,82,1112,85,0,1,4,-3
1997,1400,63,1257,78,0,10,6,4
1997,1143,57,1314,63,0,5,1,4
1997,1151,65,1344,71,0,14,10,4
1997,1428,59,1246,72,0,2,1,1
1997,1417,72,1278,80,0,2,1,1
1997,1344,92,1112,96,0,10,4,6
1997,1257,74,1314,97,0,6,1,5
1997,1314,58,1112,66,0,1,4,-3
1997,1278,69,1246,78,0,1,1,0
1997,1246,79,1112,84,0,1,4,-3
1998,1311,60,1112,99,0,16,1,15
1998,1304,65,1116,74,0,11,6,5
1998,1227,62,1150,77,0,9,8,1
1998,1319,62,1153,65,0,15,2,13
1998,1192,85,1163,93,0,15,2,13
1998,1375,51,1228,64,0,12,5,7
1998,1397,81,1229,82,0,8,9,-1
1998,1328,87,1231,94,0,10,7,3
1998,1429,68,1268,82,0,13,4,9
1998,1185,71,1277,83,0,13,4,9
1998,1298,52,1314,88,0,16,1,15
1998,1424,57,1343,69,0,12,5,7
1998,1376,61,1350,62,0,3,14,-11
1998,1362,68,1428,85,0,14,3,11
1998,1462,68,1449,69,0,6,11,-5
1998,1396,52,1452,82,0,7,10,-3
1998,1385,64,1178,66,0,7,10,-3
1998,1347,63,1181,99,0,16,1,15
1998,1395,87,1199,96,0,5,12,-7
1998,1341,52,1242,110,0,16,1,15
1998,1354,67,1246,82,0,15,2,13
1998,1172,61,1276,80,0,14,3,11
1998,1139,62,1307,79,0,13,4,9
1998,1203,59,1329,74,0,9,8,1
1998,1174,56,1345,95,0,15,2,13
1998,1293,74,1348,97,0,9,8,1
1998,1269,46,1387,51,0,7,10,-3
1998,1158,57,1390,67,0,14,3,11
1998,1233,61,1393,63,0,12,5,7
1998,1274,62,1417,65,0,11,6,5
1998,1279,69,1434,70,0,4,13,-9
1998,1155,72,1444,75,0,6,11,-5
1998,1229,49,1112,82,0,9,1,8
1998,1231,68,1163,78,0,7,2,5
1998,1228,61,1268,67,0,5,4,1
1998,1343,56,1277,63,0,5,4,1
1998,1150,83,1314,93,0,8,1,7
1998,1116,69,1428,75,0,6,3,3
1998,1350,66,1449,81,0,14,11,3
1998,1153,74,1452,75,0,2,10,-8
1998,1329,73,1181,79,0,8,1,7
1998,1387,61,1246,88,0,10,2,8
1998,1178,65,1345,80,0,10,2,8
1998,1242,75,1348,80,0,1,8,-7
1998,1444,65,1390,83,0,11,3,8
1998,1307,46,1393,56,0,4,5,-1
1998,1276,82,1417,85,0,3,6,-3
1998,1199,77,1434,83,0,12,13,-1
1998,1268,79,1112,87,0,4,1,3
1998,1449,74,1163,75,0,11,2,9
1998,1277,58,1314,73,0,4,1,3
1998,1452,62,1428,65,0,10,3,7
1998,1393,67,1181,80,0,5,1,4
1998,1417,68,1246,94,0,6,2,4
1998,1434,68,1348,74,0,13,8,5
1998,1345,59,1390,67,0,2,3,-1
1998,1163,64,1314,75,0,2,1,1
1998,1112,51,1428,76,0,1,3,-2
1998,1181,84,1246,86,0,1,2,-1
1998,1348,77,1390,79,0,8,3,5
1998,1390,85,1246,86,0,3,2,1
1998,1314,59,1428,65,0,1,3,-2
1998,1428,69,1246,78,0,3,2,1
1999,1373,80,1116,94,0,13,4,9
1999,1457,41,1120,80,0,16,1,15
1999,1427,66,1163,91,0,16,1,15
1999,1257,58,1166,62,0,7,10,-3
1999,1417,53,1178,56,0,5,12,-7
1999,1335,61,1196,75,0,11,6,5
1999,1278,63,1211,75,0,7,10,-3
1999,1203,88,1231,108,0,11,6,5
1999,1412,64,1234,77,0,12,5,7
1999,1434,60,1268,82,0,15,2,13
1999,1281,59,1307,61,0,8,9,-1
1999,1293,58,1326,72,0,13,4,9
1999,1393,61,1329,69,0,8,9,-1
1999,1359,43,1385,69,0,14,3,11
1999,1108,57,1390,69,0,15,2,13
1999,1314,74,1451,76,0,3,14,-11
1999,1348,70,1150,81,0,12,5,7
1999,1206,48,1153,72,0,14,3,11
1999,1197,58,1181,99,0,16,1,15
1999,1191,74,1242,95,0,11,6,5
1999,1308,60,1246,82,0,14,3,11
1999,1248,54,1274,75,0,15,2,13
1999,1449,58,1275,59,0,7,10,-3
1999,1291,53,1277,76,0,16,1,15
1999,1437,70,1279,72,0,8,9,-1
1999,1458,32,1283,43,0,5,12,-7
1999,1112,60,1328,61,0,4,13,-9
1999,1400,54,1345,58,0,7,10,-3
1999,1245,54,1396,61,0,11,6,5
1999,1174,52,1397,62,0,13,4,9
1999,1158,53,1409,62,0,8,9,-1
1999,1117,58,1428,80,0,15,2,13
1999,1329,74,1120,81,0,9,1,8
1999,1307,56,1163,78,0,9,1,8
1999,1451,74,1196,82,0,14,6,8
1999,1390,74,1211,82,0,2,10,-8
1999,1116,72,1234,82,0,4,5,-1
1999,1166,63,1268,75,0,10,2,8
1999,1178,44,1326,75,0,12,4,8
1999,1231,61,1385,86,0,6,3,3
1999,1409,56,1181,97,0,9,1,8
1999,1242,88,1246,92,0,6,3,3
1999,1428,58,1275,66,0,2,10,-8
1999,1279,66,1277,74,0,9,1,8
1999,1397,51,1283,81,0,4,12,-8
1999,1150,72,1328,85,0,5,13,-8
1999,1274,63,1345,73,0,2,10,-8
1999,1153,54,1396,64,0,3,6,-3
1999,1234,68,1163,78,0,5,1,4
1999,1196,72,1211,73,0,6,10,-4
1999,1120,64,1326,72,0,1,4,-3
1999,1268,62,1385,76,0,2,3,-1
1999,1283,61,1181,78,0,12,1,11
1999,1275,43,1246,58,0,10,3,7
1999,1328,46,1277,54,0,13,1,12
1999,1345,55,1396,77,0,10,6,4
1999,1211,62,1163,67,0,10,1,9
1999,1385,74,1326,77,0,3,4,-1
1999,1396,64,1181,85,0,6,1,5
1999,1246,66,1277,73,0,3,1,2
1999,1326,58,1163,64,0,4,1,3
1999,1277,62,1181,68,0,1,1,0
1999,1181,74,1163,77,0,1,1,0
2000,1238,47,1112,71,0,16,1,15
2000,1166,69,1120,72,0,10,7,3
2000,1257,66,1211,77,0,7,10,-3
2000,1148,78,1235,88,0,15,2,13
2000,1382,80,1246,85,0,12,5,7
2000,1369,61,1261,64,0,13,4,9
2000,1233,59,1268,74,0,14,3,11
2000,1434,38,1277,65,0,16,1,15
2000,1457,50,1328,74,0,14,3,11
2000,1173,61,1345,62,0,11,6,5
2000,1319,56,1385,61,0,15,2,13
2000,1359,65,1393,79,0,13,4,9
2000,1232,61,1400,77,0,12,5,7
2000,1123,57,1417,65,0,11,6,5
2000,1387,45,1428,48,0,9,8,1
2000,1201,56,1458,66,0,9,8,1
2000,1423,47,1153,64,0,15,2,13
2000,1429,67,1163,75,0,12,5,7
2000,1249,55,1181,82,0,16,1,15
2000,1139,68,1196,69,0,12,5,7
2000,1335,58,1228,68,0,13,4,9
2000,1177,77,1242,81,0,9,8,1
2000,1116,71,1274,75,0,11,6,5
2000,1281,70,1314,84,0,9,8,1
2000,1111,61,1326,87,0,14,3,11
2000,1220,66,1329,86,0,14,3,11
2000,1231,57,1337,77,0,6,11,-5
2000,1332,71,1371,72,0,7,10,-3
2000,1354,65,1390,84,0,16,1,15
2000,1248,47,1396,73,0,15,2,13
2000,1418,58,1397,63,0,13,4,9
2000,1424,62,1409,89,0,10,7,3
2000,1385,76,1211,82,0,2,10,-8
2000,1120,60,1235,79,0,7,2,5
2000,1400,67,1261,72,0,5,4,1
2000,1428,61,1277,73,0,8,1,7
2000,1328,62,1345,66,0,3,6,-3
2000,1246,50,1393,52,0,5,4,1
2000,1268,70,1417,105,0,3,6,-3
2000,1112,59,1458,66,0,1,8,-7
2000,1242,64,1181,69,0,8,1,7
2000,1228,76,1196,93,0,4,5,-1
2000,1326,62,1274,75,0,3,6,-3
2000,1390,53,1314,60,0,1,8,-7
2000,1337,67,1329,75,0,11,3,8
2000,1396,65,1371,67,0,2,10,-8
2000,1163,51,1397,65,0,5,4,1
2000,1153,61,1409,69,0,2,7,-5
2000,1417,56,1235,80,0,6,2,4
2000,1393,58,1277,75,0,4,1,3
2000,1211,66,1345,75,0,10,6,4
2000,1261,48,1458,61,0,4,8,-4
2000,1181,78,1196,87,0,1,5,-4
2000,1397,69,1314,74,0,4,8,-4
2000,1371,66,1329,68,0,10,3,7
2000,1274,71,1409,80,0,6,7,-1
2000,1235,64,1277,75,0,2,1,1
2000,1345,60,1458,64,0,6,8,-2
2000,1329,65,1196,77,0,3,5,-2
2000,1409,55,1314,59,0,7,8,-1
2000,1314,59,1196,71,0,8,5,3
2000,1458,41,1277,53,0,8,1,7
2000,1196,76,1277,89,0,5,1,4
2001,1457,67,1322,71,0,16,16,0
2001,1381,65,1130,68,0,14,3,11
2001,1140,59,1153,84,0,12,5,7
2001,1284,52,1181,95,0,16,1,15
2001,1116,61,1207,63,0,7,10,-3
2001,1458,49,1209,50,0,6,11,-5
2001,1235,57,1214,58,0,2,15,-13
2001,1166,56,1234,69,0,10,7,3
2001,1231,73,1245,77,0,4,13,-9
2001,1221,68,1246,72,0,15,2,13
2001,1206,80,1268,83,0,14,3,11
2001,1208,68,1281,70,0,8,9,-1
2001,1210,62,1386,66,0,8,9,-1
2001,1422,60,1390,89,0,16,1,15
2001,1220,48,1417,61,0,13,4,9
2001,1329,54,1425,69,0,11,6,5
2001,1326,68,1429,77,0,5,12,-7
2001,1183,76,1112,101,0,15,2,13
2001,1448,63,1139,79,0,7,10,-3
2001,1397,63,1150,70,0,8,9,-1
2001,1443,56,1196,69,0,14,3,11
2001,1143,70,1201,82,0,8,9,-1
2001,1438,85,1211,86,0,5,12,-7
2001,1322,54,1228,96,0,16,1,15
2001,1328,68,1232,70,0,4,13,-9
2001,1169,75,1242,99,0,13,4,9
2001,1106,35,1277,69,0,16,1,15
2001,1233,70,1279,72,0,14,3,11
2001,1343,48,1314,70,0,15,2,13
2001,1462,71,1323,83,0,11,6,5
2001,1344,59,1336,69,0,10,7,3
2001,1218,69,1393,79,0,12,5,7
2001,1400,65,1396,79,0,6,11,-5
2001,1245,43,1153,66,0,13,5,8
2001,1281,81,1181,94,0,9,1,8
2001,1214,57,1207,76,0,15,10,5
2001,1234,79,1246,92,0,7,2,5
2001,1209,60,1268,79,0,11,3,8
2001,1386,83,1390,90,0,9,1,8
2001,1429,50,1417,75,0,12,4,8
2001,1130,71,1425,74,0,3,6,-3
2001,1139,52,1112,73,0,10,2,8
2001,1232,68,1211,85,0,13,12,1
2001,1150,61,1228,79,0,9,1,8
2001,1393,58,1242,87,0,5,4,1
2001,1201,65,1277,81,0,9,1,8
2001,1323,56,1279,59,0,6,3,3
2001,1314,74,1336,82,0,2,7,-5
2001,1196,54,1396,75,0,3,11,-8
2001,1417,63,1181,76,0,4,1,3
2001,1207,66,1268,76,0,10,3,7
2001,1153,65,1390,78,0,5,1,4
2001,1246,76,1425,80,0,2,6,-4
2001,1279,56,1112,66,0,3,2,1
2001,1242,64,1228,80,0,4,1,3
2001,1211,62,1277,77,0,12,1,11
2001,1336,72,1396,84,0,7,11,-4
2001,1425,69,1181,79,0,6,1,5
2001,1390,73,1268,87,0,1,3,-2
2001,1228,81,1112,87,0,1,2,-1
2001,1396,62,1277,69,0,11,1,10
2001,1277,61,1112,80,0,1,2,-1
2001,1268,84,1181,95,0,3,1,2
2001,1112,72,1181,82,0,2,1,1
2002,1108,77,1373,81,0,16,16,0
2002,1194,78,1104,86,0,15,2,13
2002,1364,81,1112,86,0,14,3,11
2002,1457,37,1181,84,0,16,1,15
2002,1428,56,1231,75,0,12,5,7
2002,1221,59,1242,70,0,16,1,15
2002,1329,61,1245,69,0,7,10,-3
2002,1434,68,1246,83,0,13,4,9
2002,1274,80,1281,93,0,5,12,-7
2002,1150,63,1323,82,0,9,8,1
2002,1172,64,1326,69,0,13,4,9
2002,1285,62,1332,81,0,15,2,13
2002,1443,68,1390,84,0,9,8,1
2002,1266,69,1409,71,0,5,12,-7
2002,1425,89,1423,93,0,4,13,-9
2002,1337,74,1448,83,0,10,7,3
2002,1211,66,1461,73,0,6,11,-5
2002,1335,75,1143,82,0,11,6,5
2002,1131,52,1153,90,0,16,1,15
2002,1214,67,1163,78,0,15,2,13
2002,1196,82,1166,83,0,5,12,-7
2002,1293,68,1208,85,0,14,3,11
2002,1361,64,1228,93,0,13,4,9
2002,1373,70,1268,85,0,16,1,15
2002,1270,58,1280,70,0,14,3,11
2002,1277,58,1301,69,0,10,7,3
2002,1227,63,1328,71,0,15,2,13
2002,1148,54,1338,71,0,14,3,11
2002,1403,68,1356,76,0,6,11,-5
2002,1130,57,1400,70,0,11,6,5
2002,1279,58,1417,80,0,9,8,1
2002,1385,70,1458,80,0,9,8,1
2002,1218,58,1462,70,0,10,7,3
2002,1461,60,1112,68,0,11,3,8
2002,1323,77,1181,84,0,8,1,7
2002,1423,67,1231,76,0,13,5,8
2002,1390,63,1242,86,0,8,1,7
2002,1104,58,1245,71,0,2,10,-8
2002,1409,82,1246,87,0,12,4,8
2002,1326,67,1281,83,0,4,12,-8
2002,1448,87,1332,92,0,7,2,5
2002,1301,74,1163,77,0,7,2,5
2002,1166,60,1228,72,0,12,4,8
2002,1458,57,1268,87,0,8,1,7
2002,1462,65,1328,78,0,7,2,5
2002,1143,50,1338,63,0,6,3,3
2002,1208,75,1356,77,0,3,11,-8
2002,1280,64,1400,68,0,3,6,-3
2002,1153,101,1417,105,0,1,8,-7
2002,1181,73,1231,74,0,1,5,-4
2002,1338,73,1245,78,0,3,10,-7
2002,1417,73,1281,82,0,8,12,-4
2002,1112,67,1328,88,0,3,2,1
2002,1356,59,1163,71,0,11,2,9
2002,1228,69,1242,73,0,4,1,3
2002,1246,68,1268,78,0,4,1,3
2002,1400,70,1332,72,0,6,2,4
2002,1245,69,1231,81,0,10,5,5
2002,1281,75,1328,81,0,12,2,10
2002,1332,86,1242,104,0,2,1,1
2002,1163,82,1268,90,0,2,1,1
2002,1328,64,1231,73,0,2,5,-3
2002,1242,88,1268,97,0,1,1,0
2002,1231,52,1268,64,0,5,1,4
2003,1411,84,1421,92,0,16,16,0
2003,1436,51,1112,80,0,16,1,15
2003,1272,71,1113,84,0,7,10,-3
2003,1166,73,1141,79,0,6,11,-5
2003,1301,74,1143,76,0,9,8,1
2003,1140,53,1163,58,0,12,5,7
2003,1161,57,1181,67,0,14,3,11
2003,1153,69,1211,74,0,8,9,-1
2003,1443,60,1228,65,0,13,4,9
2003,1429,61,1242,64,0,15,2,13
2003,1221,68,1266,72,0,14,3,11
2003,1356,71,1281,72,0,11,6,5
2003,1454,69,1323,70,0,12,5,7
2003,1354,54,1328,71,0,16,1,15
2003,1360,69,1390,77,0,13,4,9
2003,1173,71,1409,84,0,4,13,-9
2003,1451,74,1458,81,0,12,5,7
2003,1386,63,1120,65,0,7,10,-3
2003,1280,46,1139,47,0,5,12,-7
2003,1358,55,1196,85,0,15,2,13
2003,1104,62,1231,67,0,10,7,3
2003,1237,64,1246,95,0,16,1,15
2003,1122,64,1257,86,0,13,4,9
2003,1423,73,1268,75,0,11,6,5
2003,1160,64,1277,79,0,10,7,3
2003,1335,63,1329,77,0,11,6,5
2003,1447,61,1338,87,0,15,2,13
2003,1261,56,1345,80,0,8,9,-1
2003,1264,65,1393,76,0,14,3,11
2003,1421,61,1400,82,0,16,1,15
2003,1332,58,1428,60,0,8,9,-1
2003,1190,73,1448,76,0,15,2,13
2003,1407,59,1462,71,0,14,3,11
2003,1211,95,1112,96,0,9,1,8
2003,1390,74,1163,85,0,4,5,-1
2003,1141,60,1181,86,0,11,3,8
2003,1113,76,1242,108,0,10,2,8
2003,1281,92,1266,101,0,6,3,3
2003,1228,60,1323,68,0,4,5,-1
2003,1143,65,1328,74,0,8,1,7
2003,1409,60,1458,61,0,13,5,8
2003,1448,62,1120,68,0,2,10,-8
2003,1257,71,1139,79,0,4,12,-8
2003,1428,54,1246,74,0,9,1,8
2003,1462,64,1268,77,0,3,6,-3
2003,1196,46,1277,68,0,2,7,-5
2003,1231,52,1338,74,0,7,2,5
2003,1329,56,1393,68,0,6,3,3
2003,1345,67,1400,77,0,9,1,8
2003,1323,71,1112,88,0,5,1,4
2003,1181,65,1242,69,0,3,2,1
2003,1458,57,1246,63,0,5,1,4
2003,1338,74,1266,77,0,2,3,-1
2003,1268,58,1277,60,0,6,7,-1
2003,1139,54,1328,65,0,12,1,11
2003,1120,78,1393,79,0,10,3,7
2003,1163,78,1400,82,0,5,1,4
2003,1112,75,1242,78,0,1,2,-1
2003,1246,69,1266,83,0,1,3,-2
2003,1328,47,1393,63,0,1,3,-2
2003,1277,76,1400,85,0,7,1,6
2003,1266,61,1242,94,0,3,2,1
2003,1400,84,1393,95,0,1,3,-2
2003,1242,78,1393,81,0,2,3,-1
2004,1250,57,1197,72,0,16,16,0
2004,1356,64,1104,65,0,9,8,1
2004,1436,53,1163,70,0,15,2,13
2004,1173,69,1177,76,0,10,7,3
2004,1106,61,1181,96,0,16,1,15
2004,1434,49,1211,76,0,15,2,13
2004,1196,60,1264,75,0,5,12,-7
2004,1431,83,1268,86,0,13,4,9
2004,1277,66,1305,72,0,7,10,-3
2004,1102,52,1314,63,0,11,6,5
2004,1112,76,1371,80,0,9,8,1
2004,1251,63,1386,82,0,16,1,15
2004,1427,45,1390,71,0,16,1,15
2004,1140,75,1393,80,0,12,5,7
2004,1343,49,1400,66,0,14,3,11
2004,1150,73,1403,76,0,9,8,1
2004,1433,78,1448,79,0,13,4,9
2004,1428,51,1130,58,0,11,6,5
2004,1190,77,1153,80,0,13,4,9
2004,1320,60,1210,65,0,14,3,11
2004,1293,53,1228,72,0,12,5,7
2004,1227,53,1242,78,0,13,4,9
2004,1197,76,1246,96,0,16,1,15
2004,1376,43,1272,59,0,10,7,3
2004,1284,52,1280,85,0,15,2,13
2004,1418,52,1301,61,0,14,3,11
2004,1186,56,1329,75,0,15,2,13
2004,1344,58,1334,66,0,5,12,-7
2004,1416,44,1338,53,0,14,3,11
2004,1449,100,1412,102,0,8,9,-1
2004,1444,58,1435,71,0,11,6,5
2004,1350,64,1458,76,0,11,6,5
2004,1257,70,1462,80,0,10,7,3
2004,1390,67,1104,70,0,1,8,-7
2004,1177,55,1163,72,0,7,2,5
2004,1371,62,1181,90,0,8,1,7
2004,1211,72,1305,91,0,2,10,-8
2004,1403,65,1386,70,0,8,1,7
2004,1268,70,1393,72,0,4,5,-1
2004,1314,75,1400,78,0,6,3,3
2004,1264,80,1448,84,0,12,4,8
2004,1130,54,1210,57,0,6,3,3
2004,1153,68,1228,92,0,4,5,-1
2004,1334,63,1242,78,0,12,4,8
2004,1272,53,1329,70,0,7,2,5
2004,1458,55,1338,59,0,6,3,3
2004,1246,75,1412,76,0,1,9,-8
2004,1301,73,1435,75,0,3,6,-3
2004,1280,74,1462,89,0,2,7,-5
2004,1393,71,1104,80,0,5,8,-3
2004,1435,53,1163,73,0,6,2,4
2004,1338,51,1329,63,0,3,2,1
2004,1448,80,1386,84,0,4,1,3
2004,1228,62,1181,72,0,5,1,4
2004,1305,67,1210,72,0,10,3,7
2004,1412,74,1242,100,0,9,4,5
2004,1400,71,1462,79,0,3,7,-4
2004,1104,71,1163,87,0,8,2,6
2004,1386,62,1329,64,0,1,2,-1
2004,1462,63,1181,66,0,7,1,6
2004,1242,71,1210,79,0,4,3,1
2004,1181,78,1163,79,0,1,2,-1
2004,1329,65,1210,67,0,2,3,-1
2004,1210,73,1163,82,0,3,2,1
2005,1105,69,1324,79,0,16,16,0
2005,1429,53,1112,66,0,14,3,11
2005,1335,65,1130,85,0,13,4,9
2005,1234,64,1153,76,0,10,7,3
2005,1457,64,1211,74,0,14,3,11
2005,1192,55,1228,67,0,16,1,15
2005,1184,64,1246,72,0,15,2,13
2005,1400,57,1305,61,0,8,9,-1
2005,1310,67,1328,84,0,14,3,11
2005,1338,71,1334,79,0,9,8,1
2005,1417,66,1403,78,0,11,6,5
2005,1261,68,1412,82,0,6,11,-5
2005,1431,54,1428,60,0,11,6,5
2005,1151,54,1448,70,0,15,2,13
2005,1285,77,1449,88,0,16,1,15
2005,1166,61,1452,63,0,10,7,3
2005,1104,73,1454,83,0,5,12,-7
2005,1242,63,1137,64,0,3,14,-11
2005,1416,71,1163,77,0,15,2,13
2005,1175,46,1181,57,0,16,1,15
2005,1325,62,1196,67,0,13,4,9
2005,1203,68,1210,80,0,12,5,7
2005,1278,53,1235,64,0,8,9,-1
2005,1418,62,1257,68,0,13,4,9
2005,1330,81,1277,89,0,12,5,7
2005,1390,70,1280,93,0,8,9,-1
2005,1150,63,1301,75,0,7,10,-3
2005,1324,68,1314,96,0,16,1,15
2005,1368,50,1329,63,0,15,2,13
2005,1388,56,1356,65,0,10,7,3
2005,1393,57,1436,60,0,4,13,-9
2005,1307,47,1437,55,0,12,5,7
2005,1320,52,1458,57,0,11,6,5
2005,1412,63,1112,85,0,11,3,8
2005,1305,59,1228,71,0,9,1,8
2005,1153,60,1246,69,0,7,2,5
2005,1211,69,1403,71,0,3,6,-3
2005,1328,58,1428,67,0,3,6,-3
2005,1334,79,1449,97,0,8,1,7
2005,1448,105,1452,111,0,2,7,-5
2005,1130,75,1454,83,0,4,12,-8
2005,1280,55,1181,63,0,9,1,8
2005,1210,54,1257,76,0,5,4,1
2005,1436,61,1277,72,0,13,5,8
2005,1163,62,1301,65,0,2,10,-8
2005,1235,65,1314,92,0,9,1,8
2005,1356,77,1329,85,0,7,2,5
2005,1196,65,1437,76,0,4,5,-1
2005,1137,62,1458,71,0,14,6,8
2005,1329,78,1112,79,0,2,3,-1
2005,1454,63,1228,77,0,12,1,11
2005,1449,79,1257,93,0,1,4,-3
2005,1403,60,1452,65,0,6,7,-1
2005,1428,52,1246,62,0,6,2,4
2005,1181,68,1277,78,0,1,5,-4
2005,1437,66,1314,67,0,5,1,4
2005,1301,56,1458,65,0,10,6,4
2005,1112,89,1228,90,0,3,1,2
2005,1452,85,1257,93,0,7,4,3
2005,1246,88,1277,94,0,2,5,-3
2005,1458,82,1314,88,0,6,1,5
2005,1257,57,1228,72,0,4,1,3
2005,1277,71,1314,87,0,5,1,4
2005,1228,70,1314,75,0,1,1,0
2006,1214,49,1284,71,0,16,16,0
2006,1266,85,1104,90,0,7,10,-3
2006,1334,76,1130,88,0,13,4,9
2006,1380,54,1181,70,0,16,1,15
2006,1375,50,1196,76,0,14,3,11
2006,1423,85,1203,88,0,9,8,1
2006,1462,75,1211,79,0,14,3,11
2006,1102,69,1228,78,0,13,4,9
2006,1361,83,1231,87,0,11,6,5
2006,1233,64,1261,80,0,13,4,9
2006,1305,79,1285,87,0,5,12,-7
2006,1457,61,1397,63,0,15,2,13
2006,1393,58,1401,66,0,5,12,-7
2006,1125,44,1417,78,0,15,2,13
2006,1429,61,1449,75,0,12,5,7
2006,1328,74,1454,82,0,6,11,-5
2006,1371,66,1455,86,0,10,7,3
2006,1458,75,1112,94,0,9,8,1
2006,1242,73,1133,77,0,4,13,-9
2006,1116,55,1137,59,0,8,9,-1
2006,1107,59,1163,72,0,16,1,15
2006,1277,65,1206,75,0,6,11,-5
2006,1320,49,1207,54,0,10,7,3
2006,1412,64,1246,69,0,9,8,1
2006,1331,78,1272,94,0,16,1,15
2006,1143,52,1301,58,0,7,10,-3
2006,1293,65,1314,69,0,14,3,11
2006,1234,63,1322,64,0,3,14,-11
2006,1172,62,1326,70,0,15,2,13
2006,1245,64,1338,79,0,12,5,7
2006,1335,52,1400,60,0,15,2,13
2006,1284,45,1437,58,0,16,1,15
2006,1356,46,1452,64,0,11,6,5
2006,1285,56,1130,69,0,12,4,8
2006,1203,61,1181,74,0,8,1,7
2006,1454,60,1196,82,0,11,3,8
2006,1231,80,1211,90,0,6,3,3
2006,1401,57,1261,58,0,12,4,8
2006,1104,59,1417,62,0,10,2,8
2006,1228,64,1449,67,0,4,5,-1
2006,1397,73,1455,80,0,2,7,-5
2006,1338,66,1133,72,0,5,13,-8
2006,1246,83,1163,87,0,8,1,7
2006,1314,60,1206,65,0,3,11,-8
2006,1326,52,1207,70,0,2,7,-5
2006,1137,56,1272,72,0,9,1,8
2006,1301,54,1400,75,0,10,2,8
2006,1112,78,1437,82,0,8,1,7
2006,1322,54,1452,67,0,14,6,8
2006,1181,54,1261,62,0,1,4,-3
2006,1133,64,1272,80,0,13,1,12
2006,1452,71,1400,74,0,6,2,4
2006,1211,71,1417,73,0,3,2,1
2006,1449,92,1163,98,0,5,1,4
2006,1207,53,1196,57,0,7,3,4
2006,1455,55,1206,63,0,7,11,-4
2006,1130,59,1437,60,0,4,1,3
2006,1400,60,1261,70,0,2,4,-2
2006,1272,45,1417,50,0,1,2,-1
2006,1437,62,1196,75,0,1,3,-2
2006,1163,84,1206,86,0,1,11,-10
2006,1206,58,1196,73,0,11,3,8
2006,1261,45,1417,59,0,4,2,2
2006,1417,57,1196,73,0,2,3,-1
2007,1197,69,1310,77,0,16,16,0
2007,1403,75,1130,84,0,10,7,3
2007,1330,46,1139,57,0,12,5,7
2007,1125,55,1207,80,0,15,2,13
2007,1211,57,1231,70,0,10,7,3
2007,1390,58,1257,78,0,11,6,5
2007,1172,70,1268,82,0,13,4,9
2007,1266,49,1277,61,0,8,9,-1
2007,1184,65,1314,86,0,16,1,15
2007,1148,57,1326,78,0,16,1,15
2007,1460,58,1338,79,0,14,3,11
2007,1335,52,1401,68,0,14,3,11
2007,1451,42,1417,70,0,15,2,13
2007,1181,77,1433,79,0,6,11,-5
2007,1203,44,1435,77,0,11,6,5
2007,1331,54,1450,70,0,14,3,11
2007,1140,77,1462,79,0,8,9,-1
2007,1238,69,1196,112,0,16,1,15
2007,1310,67,1242,107,0,16,1,15
2007,1437,58,1246,67,0,9,8,1
2007,1317,58,1272,73,0,15,2,13
2007,1166,71,1305,77,0,10,7,3
2007,1275,56,1332,58,0,14,3,11
2007,1112,63,1345,72,0,8,9,-1
2007,1221,51,1356,61,0,13,4,9
2007,1253,86,1397,121,0,12,5,7
2007,1308,67,1400,79,0,13,4,9
2007,1210,63,1424,67,0,10,7,3
2007,1116,60,1425,77,0,12,5,7
2007,1107,57,1438,84,0,13,4,9
2007,1228,52,1439,54,0,12,5,7
2007,1323,64,1457,74,0,6,11,-5
2007,1394,63,1458,76,0,15,2,13
2007,1268,59,1139,62,0,4,5,-1
2007,1130,55,1207,62,0,7,2,5
2007,1277,67,1314,81,0,9,1,8
2007,1462,71,1326,78,0,9,1,8
2007,1433,79,1338,84,0,11,3,8
2007,1257,69,1401,72,0,6,3,3
2007,1231,49,1417,54,0,7,2,5
2007,1450,74,1435,78,0,3,6,-3
2007,1345,67,1196,74,0,9,1,8
2007,1246,76,1242,88,0,8,1,7
2007,1305,62,1272,78,0,7,2,5
2007,1457,61,1332,75,0,11,3,8
2007,1439,48,1356,63,0,5,4,1
2007,1438,74,1397,77,0,4,5,-1
2007,1458,68,1424,74,0,2,7,-5
2007,1400,68,1425,87,0,4,5,-1
2007,1356,58,1242,61,0,4,1,3
2007,1401,64,1272,65,0,3,2,1
2007,1397,84,1326,85,0,5,1,4
2007,1338,55,1417,64,0,3,2,1
2007,1139,57,1196,65,0,5,1,4
2007,1435,65,1207,66,0,6,2,4
2007,1425,64,1314,74,0,5,1,4
2007,1424,72,1332,76,0,7,3,4
2007,1272,76,1326,92,0,2,1,1
2007,1242,55,1417,68,0,1,2,-1
2007,1332,77,1196,85,0,3,1,2
2007,1314,84,1207,96,0,1,2,-1
2007,1417,66,1196,76,0,2,1,1
2007,1207,60,1326,67,0,2,1,1
2007,1326,75,1196,84,0,1,1,0
2008,1164,60,1291,69,0,16,16,0
2008,1125,70,1181,71,0,15,2,13
2008,1340,61,1242,85,0,16,1,15
2008,1425,67,1243,80,0,6,11,-5
2008,1246,66,1266,74,0,11,6,5
2008,1396,61,1277,72,0,12,5,7
2008,1206,50,1323,68,0,12,5,7
2008,1331,63,1338,82,0,13,4,9
2008,1124,79,1345,90,0,11,6,5
2008,1165,53,1390,77,0,14,3,11
2008,1140,62,1401,67,0,8,9,-1
2008,1290,29,1417,70,0,16,1,15
2008,1245,58,1424,71,0,9,8,1
2008,1457,40,1450,71,0,13,4,9
2008,1112,65,1452,75,0,10,7,3
2008,1168,56,1458,71,0,14,3,11
2008,1208,61,1462,73,0,14,3,11
2008,1231,72,1116,86,0,8,9,-1
2008,1375,61,1139,81,0,10,7,3
2008,1211,76,1172,82,0,7,10,-3
2008,1420,47,1207,66,0,15,2,13
2008,1129,61,1257,79,0,14,3,11
2008,1426,63,1272,87,0,16,1,15
2008,1388,64,1274,78,0,10,7,3
2008,1332,69,1280,76,0,9,8,1
2008,1291,74,1314,113,0,16,1,15
2008,1386,64,1328,72,0,11,6,5
2008,1163,69,1360,70,0,4,13,-9
2008,1435,62,1373,83,0,4,13,-9
2008,1110,57,1397,72,0,15,2,13
2008,1122,54,1400,74,0,15,2,13
2008,1155,69,1437,75,0,5,12,-7
2008,1179,99,1443,101,0,5,12,-7
2008,1424,56,1242,75,0,8,1,7
2008,1338,54,1277,65,0,4,5,-1
2008,1266,81,1390,82,0,6,3,3
2008,1401,49,1417,51,0,9,1,8
2008,1323,41,1450,61,0,5,4,1
2008,1181,67,1452,73,0,2,7,-5
2008,1243,55,1458,72,0,11,3,8
2008,1345,78,1462,85,0,6,3,3
2008,1207,70,1172,74,0,2,10,-8
2008,1328,48,1257,78,0,6,3,3
2008,1280,74,1272,77,0,8,1,7
2008,1116,77,1314,108,0,9,1,8
2008,1139,71,1397,76,0,7,2,5
2008,1274,72,1400,75,0,7,2,5
2008,1373,72,1437,84,0,13,12,1
2008,1360,63,1443,72,0,13,12,1
2008,1397,60,1257,79,0,2,3,-1
2008,1450,47,1314,68,0,4,1,3
2008,1443,78,1417,88,0,12,1,11
2008,1452,75,1462,79,0,7,3,4
2008,1458,56,1172,73,0,3,10,-7
2008,1437,57,1242,72,0,12,1,11
2008,1277,74,1272,92,0,5,1,4
2008,1390,62,1400,82,0,3,2,1
2008,1257,73,1314,83,0,3,1,2
2008,1462,57,1417,76,0,3,1,2
2008,1172,57,1242,59,0,10,1,9
2008,1400,67,1272,85,0,2,1,1
2008,1314,66,1242,84,0,1,1,0
2008,1417,63,1272,78,0,1,1,0
2008,1272,68,1242,75,0,1,1,0
2009,1106,43,1287,58,0,16,16,0
2009,1151,47,1163,103,0,16,1,15
2009,1127,62,1181,86,0,15,2,13
2009,1103,64,1211,77,0,13,4,9
2009,1139,71,1261,75,0,9,8,1
2009,1143,71,1268,84,0,7,10,-3
2009,1169,70,1272,81,0,15,2,13
2009,1155,59,1276,62,0,7,10,-3
2009,1347,58,1314,101,0,16,1,15
2009,1288,54,1328,82,0,15,2,13
2009,1320,56,1345,61,0,12,5,7
2009,1278,62,1400,76,0,10,7,3
2009,1140,66,1401,79,0,8,9,-1
2009,1433,64,1417,65,0,11,6,5
2009,1110,67,1437,80,0,14,3,11
2009,1228,72,1443,76,0,5,12,-7
2009,1280,58,1449,71,0,13,4,9
2009,1428,71,1112,84,0,5,12,-7
2009,1396,57,1113,66,0,11,6,5
2009,1448,69,1156,84,0,4,13,-9
2009,1452,60,1173,68,0,6,11,-5
2009,1295,74,1242,84,0,14,3,11
2009,1287,54,1257,74,0,16,1,15
2009,1429,57,1266,58,0,11,6,5
2009,1352,62,1277,77,0,15,2,13
2009,1165,59,1281,78,0,14,3,11
2009,1397,75,1329,77,0,9,8,1
2009,1190,62,1338,72,0,16,1,15
2009,1326,72,1373,74,0,8,9,-1
2009,1372,44,1393,59,0,14,3,11
2009,1130,55,1425,72,0,7,10,-3
2009,1199,59,1458,61,0,5,12,-7
2009,1340,59,1462,77,0,13,4,9
2009,1401,66,1163,92,0,9,1,8
2009,1400,69,1181,74,0,7,2,5
2009,1443,81,1211,83,0,12,4,8
2009,1268,70,1272,89,0,10,2,8
2009,1261,70,1314,84,0,8,1,7
2009,1276,63,1328,73,0,10,2,8
2009,1449,74,1345,76,0,4,5,-1
2009,1417,69,1437,89,0,6,3,3
2009,1156,57,1112,71,0,13,12,1
2009,1173,43,1242,60,0,11,3,8
2009,1373,72,1257,79,0,9,1,8
2009,1425,69,1277,74,0,10,2,8
2009,1266,79,1281,83,0,6,3,3
2009,1329,76,1338,84,0,8,1,7
2009,1113,67,1393,78,0,6,3,3
2009,1458,49,1462,60,0,12,4,8
2009,1345,60,1163,72,0,5,1,4
2009,1272,91,1281,102,0,2,3,-1
2009,1462,55,1338,60,0,4,1,3
2009,1181,54,1437,77,0,2,3,-1
2009,1112,64,1257,103,0,12,1,11
2009,1242,62,1277,67,0,3,2,1
2009,1211,77,1314,98,0,4,1,3
2009,1393,71,1328,84,0,3,2,1
2009,1281,75,1163,82,0,3,1,2
2009,1338,76,1437,78,0,1,3,-2
2009,1257,52,1277,64,0,1,2,-1
2009,1328,60,1314,72,0,2,1,1
2009,1163,73,1277,82,0,1,2,-1
2009,1437,69,1314,83,0,3,1,2
2009,1277,72,1314,89,0,2,1,1
2010,1457,44,1115,61,0,16,16,0
2010,1358,59,1124,68,0,14,3,11
2010,1431,59,1139,77,0,12,5,7
2010,1196,92,1140,99,0,10,7,3
2010,1250,74,1242,90,0,16,1,15
2010,1317,62,1243,82,0,15,2,13
2010,1190,71,1246,100,0,16,1,15
2010,1435,65,1293,66,0,4,13,-9
2010,1285,57,1307,62,0,14,3,11
2010,1424,66,1320,69,0,8,9,-1
2010,1207,83,1325,97,0,3,14,-11
2010,1323,50,1330,51,0,6,11,-5
2010,1350,71,1388,80,0,7,10,-3
2010,1361,59,1397,62,0,11,6,5
2010,1352,70,1437,73,0,15,2,13
2010,1400,80,1448,81,0,8,9,-1
2010,1266,78,1449,80,0,6,11,-5
2010,1257,62,1143,77,0,9,8,1
2010,1396,65,1165,78,0,5,12,-7
2010,1115,44,1181,73,0,16,1,15
2010,1329,59,1210,64,0,7,10,-3
2010,1199,60,1211,67,0,9,8,1
2010,1222,77,1268,89,0,13,4,9
2010,1308,67,1277,70,0,12,5,7
2010,1155,78,1281,86,0,7,10,-3
2010,1364,51,1326,68,0,15,2,13
2010,1324,66,1338,89,0,14,3,11
2010,1373,64,1345,72,0,13,4,9
2010,1436,56,1393,79,0,16,1,15
2010,1429,53,1401,69,0,12,5,7
2010,1288,50,1452,77,0,15,2,13
2010,1459,49,1458,53,0,13,4,9
2010,1278,54,1462,65,0,11,6,5
2010,1330,68,1124,76,0,11,3,8
2010,1293,52,1139,54,0,13,5,8
2010,1140,72,1243,84,0,7,2,5
2010,1448,60,1246,90,0,9,1,8
2010,1242,67,1320,69,0,1,9,-8
2010,1437,68,1388,75,0,2,10,-8
2010,1325,68,1397,83,0,14,6,8
2010,1307,64,1449,82,0,3,11,-8
2010,1458,69,1165,87,0,4,12,-8
2010,1143,53,1181,68,0,8,1,7
2010,1268,83,1277,85,0,4,5,-1
2010,1210,66,1326,75,0,10,2,8
2010,1401,61,1345,63,0,5,4,1
2010,1211,65,1393,87,0,8,1,7
2010,1281,59,1452,68,0,10,2,8
2010,1338,68,1462,71,0,3,6,-3
2010,1393,59,1139,63,0,1,5,-4
2010,1462,96,1243,101,0,6,2,4
2010,1165,45,1246,62,0,12,1,11
2010,1449,56,1452,69,0,11,2,9
2010,1388,49,1124,72,0,10,3,7
2010,1345,57,1181,70,0,4,1,3
2010,1320,52,1277,59,0,9,5,4
2010,1326,73,1397,76,0,2,6,-4
2010,1243,56,1139,63,0,2,5,-3
2010,1246,66,1452,73,0,1,2,-1
2010,1124,71,1181,78,0,3,1,2
2010,1397,69,1277,70,0,6,5,1
2010,1277,50,1139,52,0,5,5,0
2010,1452,57,1181,78,0,2,1,1
2010,1139,59,1181,61,0,5,1,4
2011,1412,52,1155,70,0,12,12,0
2011,1114,77,1421,81,0,16,16,0
2011,1106,61,1427,70,0,16,16,0
2011,1425,46,1433,59,0,11,11,0
2011,1330,58,1139,60,0,9,8,1
2011,1459,66,1140,74,0,14,3,11
2011,1281,63,1153,78,0,11,6,5
2011,1137,52,1163,81,0,14,3,11
2011,1364,51,1196,79,0,15,2,13
2011,1385,71,1211,86,0,6,11,-5
2011,1429,68,1243,73,0,12,5,7
2011,1343,57,1246,59,0,13,4,9
2011,1257,61,1287,62,0,4,13,-9
2011,1421,51,1338,74,0,16,1,15
2011,1435,66,1350,69,0,5,12,-7
2011,1294,50,1361,68,0,15,2,13
2011,1336,64,1396,66,0,10,7,3
2011,1277,76,1417,78,0,10,7,3
2011,1155,76,1452,84,0,12,5,7
2011,1125,58,1458,72,0,13,4,9
2011,1272,75,1112,77,0,12,5,7
2011,1214,45,1181,87,0,16,1,15
2011,1401,50,1199,57,0,7,10,-3
2011,1437,57,1206,61,0,9,8,1
2011,1424,62,1228,73,0,8,9,-1
2011,1131,53,1242,72,0,16,1,15
2011,1462,55,1266,66,0,6,11,-5
2011,1397,45,1276,75,0,9,8,1
2011,1254,87,1314,102,0,15,2,13
2011,1103,56,1323,69,0,15,2,13
2011,1427,46,1326,75,0,16,1,15
2011,1389,43,1345,65,0,14,3,11
2011,1232,60,1393,77,0,14,3,11
2011,1324,81,1400,85,0,13,4,9
2011,1207,56,1433,74,0,6,11,-5
2011,1208,65,1449,68,0,10,7,3
2011,1338,70,1139,71,0,1,8,-7
2011,1211,67,1140,89,0,11,3,8
2011,1153,58,1163,69,0,6,3,3
2011,1417,65,1196,73,0,7,2,5
2011,1452,63,1246,71,0,5,4,1
2011,1287,48,1350,65,0,13,12,1
2011,1396,64,1361,71,0,7,2,5
2011,1243,65,1458,70,0,5,4,1
2011,1400,69,1112,70,0,4,5,-1
2011,1276,71,1181,73,0,8,1,7
2011,1323,57,1199,71,0,2,10,-8
2011,1228,59,1242,73,0,9,1,8
2011,1393,62,1266,66,0,3,11,-8
2011,1449,83,1314,86,0,7,2,5
2011,1206,66,1326,98,0,8,1,7
2011,1345,76,1433,94,0,3,11,-8
2011,1181,77,1112,93,0,1,5,-4
2011,1458,54,1139,61,0,4,8,-4
2011,1361,67,1163,74,0,2,3,-1
2011,1140,74,1196,83,0,3,2,1
2011,1350,57,1242,77,0,12,1,11
2011,1326,60,1246,62,0,1,4,-3
2011,1266,63,1314,81,0,11,2,9
2011,1199,71,1433,72,0,10,11,-1
2011,1196,71,1139,74,0,2,8,-6
2011,1112,63,1163,65,0,5,3,2
2011,1314,69,1246,76,0,2,4,-2
2011,1242,61,1433,71,0,1,11,-10
2011,1433,62,1139,70,0,11,8,3
2011,1246,55,1163,56,0,4,3,1
2011,1139,41,1163,53,0,8,3,5
2012,1233,72,1140,78,0,14,14,0
2012,1290,58,1443,59,0,16,16,0
2012,1143,54,1378,65,0,12,12,0
2012,1249,59,1436,71,0,16,16,0
2012,1355,60,1124,68,0,14,3,11
2012,1424,64,1160,68,0,6,11,-5
2012,1452,54,1211,77,0,10,7,3
2012,1308,66,1231,79,0,13,4,9
2012,1163,64,1235,77,0,9,8,1
2012,1379,64,1243,70,0,9,8,1
2012,1443,66,1246,81,0,16,1,15
2012,1172,62,1257,69,0,13,4,9
2012,1140,68,1266,88,0,14,3,11
2012,1161,41,1293,58,0,11,6,5
2012,1253,68,1307,75,0,12,5,7
2012,1259,59,1326,78,0,15,2,13
2012,1421,65,1393,72,0,16,1,15
2012,1455,59,1433,62,0,5,12,-7
2012,1217,70,1435,79,0,12,5,7
2012,1285,49,1458,73,0,13,4,9
2012,1400,59,1153,65,0,11,6,5
2012,1104,57,1166,58,0,9,8,1
2012,1438,45,1196,71,0,10,7,3
2012,1382,63,1199,66,0,14,3,11
2012,1125,59,1207,74,0,14,3,11
2012,1178,50,1242,65,0,15,2,13
2012,1181,70,1250,75,0,2,15,-13
2012,1254,67,1277,89,0,16,1,15
2012,1361,65,1301,79,0,6,11,-5
2012,1281,84,1313,86,0,2,15,-13
2012,1436,58,1314,77,0,16,1,15
2012,1276,60,1325,65,0,4,13,-9
2012,1388,69,1345,72,0,7,10,-3
2012,1396,44,1378,58,0,5,12,-7
2012,1272,54,1387,61,0,8,9,-1
2012,1323,63,1462,67,0,7,10,-3
2012,1160,63,1124,80,0,11,3,8
2012,1433,61,1231,63,0,12,4,8
2012,1235,71,1246,87,0,8,1,7
2012,1307,56,1257,59,0,5,4,1
2012,1293,53,1266,62,0,6,3,3
2012,1211,66,1326,73,0,7,2,5
2012,1243,59,1393,75,0,8,1,7
2012,1435,57,1458,60,0,5,4,1
2012,1199,56,1153,62,0,3,6,-3
2012,1313,50,1196,84,0,15,7,8
2012,1345,60,1242,63,0,10,2,8
2012,1387,61,1277,65,0,9,1,8
2012,1207,63,1301,66,0,3,11,-8
2012,1166,73,1314,87,0,8,1,7
2012,1378,56,1325,62,0,12,13,-1
2012,1250,58,1462,70,0,15,10,5
2012,1266,58,1196,68,0,3,7,-4
2012,1277,44,1257,57,0,1,4,-3
2012,1153,66,1326,81,0,6,2,4
2012,1458,63,1393,64,0,4,1,3
2012,1462,70,1124,75,0,10,3,7
2012,1301,57,1242,60,0,11,2,9
2012,1231,90,1246,102,0,4,1,3
2012,1325,65,1314,73,0,13,1,12
2012,1196,68,1257,72,0,7,4,3
2012,1393,70,1326,77,0,1,2,-1
2012,1314,67,1242,80,0,1,2,-1
2012,1124,70,1246,82,0,3,1,2
2012,1326,62,1242,64,0,2,2,0
2012,1257,61,1246,69,0,4,1,3
2012,1242,59,1246,67,0,2,1,1
2013,1251,72,1299,73,0,16,16,0
2013,1292,54,1388,67,0,11,11,0
2013,1254,55,1241,68,0,16,16,0
2013,1129,71,1247,80,0,13,13,0
2013,1125,64,1112,81,0,11,6,5
2013,1137,56,1139,68,0,11,6,5
2013,1424,61,1143,64,0,5,12,-7
2013,1281,72,1161,84,0,9,8,1
2013,1380,58,1211,64,0,16,1,15
2013,1307,62,1217,68,0,3,14,-11
2013,1299,48,1257,79,0,16,1,15
2013,1172,58,1266,59,0,14,3,11
2013,1388,52,1272,54,0,11,6,5
2013,1355,56,1276,71,0,13,4,9
2013,1434,54,1277,65,0,14,3,11
2013,1329,55,1332,68,0,5,12,-7
2013,1308,44,1387,64,0,13,4,9
2013,1285,34,1393,81,0,13,4,9
2013,1103,42,1433,88,0,12,5,7
2013,1338,55,1455,73,0,8,9,-1
2013,1153,63,1166,67,0,10,7,3
2013,1107,61,1181,73,0,15,2,13
2013,1207,68,1195,78,0,2,15,-13
2013,1322,47,1196,79,0,14,3,11
2013,1160,49,1228,57,0,10,7,3
2013,1241,62,1231,83,0,16,1,15
2013,1323,58,1235,76,0,7,10,-3
2013,1443,57,1242,64,0,16,1,15
2013,1243,61,1247,63,0,4,13,-9
2013,1334,49,1274,78,0,15,2,13
2013,1417,63,1278,83,0,6,11,-5
2013,1458,46,1279,57,0,5,12,-7
2013,1437,71,1314,78,0,9,8,1
2013,1233,70,1326,95,0,15,2,13
2013,1328,55,1361,70,0,10,7,3
2013,1301,72,1396,76,0,8,9,-1
2013,1217,51,1112,74,0,14,6,8
2013,1161,56,1257,82,0,8,1,7
2013,1139,72,1266,74,0,6,3,3
2013,1433,53,1276,78,0,5,4,1
2013,1272,48,1277,70,0,6,3,3
2013,1387,57,1332,74,0,4,12,-8
2013,1143,60,1393,66,0,12,4,8
2013,1211,70,1455,76,0,1,9,-8
2013,1166,50,1181,66,0,7,2,5
2013,1361,71,1195,81,0,7,15,-8
2013,1278,64,1196,78,0,11,3,8
2013,1396,52,1231,58,0,9,1,8
2013,1314,58,1242,70,0,8,1,7
2013,1279,74,1247,76,0,12,13,-1
2013,1228,59,1274,63,0,7,2,5
2013,1235,75,1326,78,0,10,2,8
2013,1274,61,1266,71,0,2,3,-1
2013,1112,70,1326,73,0,6,2,4
2013,1231,50,1393,61,0,1,4,-3
2013,1247,58,1455,72,0,13,9,4
2013,1277,61,1181,71,0,3,2,1
2013,1195,50,1196,62,0,15,3,12
2013,1332,69,1257,77,0,12,1,11
2013,1242,85,1276,87,0,1,4,-3
2013,1266,39,1393,55,0,3,4,-1
2013,1326,66,1455,70,0,2,9,-7
2013,1181,63,1257,85,0,2,1,1
2013,1196,59,1276,79,0,3,4,-1
2013,1455,68,1257,72,0,9,1,8
2013,1393,56,1276,61,0,4,4,0
2013,1276,76,1257,82,0,4,1,3
2014,1291,64,1107,71,0,16,16,0
2014,1462,59,1301,74,0,12,12,0
2014,1411,69,1142,81,0,16,16,0
2014,1234,65,1397,78,0,11,11,0
2014,1386,81,1163,89,0,10,7,3
2014,1326,59,1173,60,0,6,11,-5
2014,1107,55,1196,67,0,16,1,15
2014,1153,57,1217,61,0,5,12,-7
2014,1264,64,1257,71,0,13,4,9
2014,1459,40,1276,57,0,15,2,13
2014,1174,78,1277,93,0,13,4,9
2014,1328,75,1295,80,0,5,12,-7
2014,1140,68,1332,87,0,10,7,3
2014,1160,48,1338,77,0,8,9,-1
2014,1308,69,1361,73,0,13,4,9
2014,1301,80,1387,83,0,12,5,7
2014,1444,53,1393,77,0,14,3,11
2014,1113,85,1400,87,0,10,7,3
2014,1454,53,1437,73,0,15,2,13
2014,1110,35,1458,75,0,15,2,13
2014,1451,59,1112,68,0,16,1,15
2014,1304,60,1124,74,0,11,6,5
2014,1418,66,1166,76,0,14,3,11
2014,1329,77,1211,85,0,9,8,1
2014,1300,75,1235,93,0,14,3,11
2014,1184,69,1242,80,0,15,2,13
2014,1243,49,1246,56,0,9,8,1
2014,1203,66,1272,71,0,9,8,1
2014,1181,71,1273,78,0,3,14,-11
2014,1344,77,1314,79,0,11,6,5
2014,1433,75,1372,77,0,5,12,-7
2014,1307,53,1390,58,0,7,10,-3
2014,1269,67,1397,86,0,6,11,-5
2014,1409,59,1417,76,0,13,4,9
2014,1157,59,1438,70,0,16,1,15
2014,1142,37,1455,64,0,16,1,15
2014,1437,65,1163,77,0,2,7,-5
2014,1393,53,1173,55,0,3,11,-8
2014,1338,45,1196,61,0,9,1,8
2014,1387,51,1257,66,0,5,4,1
2014,1400,65,1276,79,0,7,2,5
2014,1217,73,1277,80,0,12,4,8
2014,1295,44,1361,63,0,12,4,8
2014,1332,77,1458,85,0,7,2,5
2014,1211,61,1112,84,0,8,1,7
2014,1166,55,1124,85,0,3,6,-3
2014,1314,83,1235,85,0,6,3,3
2014,1455,76,1246,78,0,1,8,-7
2014,1242,57,1390,60,0,2,10,-8
2014,1273,63,1397,83,0,14,11,3
2014,1372,60,1417,77,0,12,4,8
2014,1272,60,1438,78,0,8,1,7
2014,1361,64,1112,70,0,4,1,3
2014,1390,72,1173,82,0,10,11,-1
2014,1417,68,1196,79,0,4,1,3
2014,1124,52,1458,69,0,6,2,4
2014,1235,76,1163,81,0,3,7,-4
2014,1257,69,1246,74,0,4,8,-4
2014,1397,71,1276,73,0,11,2,9
2014,1438,59,1277,61,0,1,4,-3
2014,1173,52,1196,62,0,11,1,10
2014,1112,63,1458,64,0,1,2,-1
2014,1277,54,1163,60,0,4,7,-3
2014,1276,72,1246,75,0,2,8,-6
2014,1196,53,1163,63,0,1,7,-6
2014,1458,73,1246,74,0,2,8,-6
2014,1246,54,1163,60,0,8,7,1
2015,1264,64,1214,74,0,16,16,0
2015,1140,90,1279,94,0,11,11,0
2015,1129,55,1173,56,0,11,11,0
2015,1316,77,1352,81,0,16,16,0
2015,1411,72,1112,93,0,15,2,13
2015,1459,53,1116,56,0,12,5,7
2015,1400,48,1139,56,0,11,6,5
2015,1345,65,1153,66,0,9,8,1
2015,1186,74,1207,84,0,13,4,9
2015,1124,56,1209,57,0,3,14,-11
2015,1214,56,1246,79,0,16,1,15
2015,1261,65,1301,66,0,9,8,1
2015,1217,65,1314,67,0,13,4,9
2015,1318,65,1323,69,0,14,3,11
2015,1433,72,1326,75,0,7,10,-3
2015,1235,59,1412,60,0,3,14,-11
2015,1374,59,1417,60,0,6,11,-5
2015,1372,50,1428,57,0,12,5,7
2015,1248,52,1437,93,0,16,1,15
2015,1279,57,1462,76,0,11,6,5
2015,1344,53,1173,66,0,6,11,-5
2015,1352,56,1181,85,0,16,1,15
2015,1295,76,1211,86,0,15,2,13
2015,1172,52,1234,83,0,10,7,3
2015,1308,56,1242,75,0,15,2,13
2015,1414,55,1257,57,0,13,4,9
2015,1434,62,1268,65,0,13,4,9
2015,1208,63,1277,70,0,10,7,3
2015,1461,54,1320,71,0,12,5,7
2015,1107,60,1328,69,0,14,3,11
2015,1329,73,1332,79,0,9,8,1
2015,1385,64,1361,76,0,9,8,1
2015,1125,67,1438,79,0,15,2,13
2015,1138,62,1452,68,0,12,5,7
2015,1231,76,1455,81,0,10,7,3
2015,1157,72,1458,86,0,16,1,15
2015,1326,58,1112,73,0,10,2,8
2015,1153,51,1246,64,0,8,1,7
2015,1437,68,1301,71,0,1,8,-7
2015,1116,78,1314,87,0,5,4,1
2015,1139,64,1323,67,0,6,3,3
2015,1412,75,1417,92,0,14,11,3
2015,1207,64,1428,75,0,4,5,-1
2015,1209,67,1462,75,0,14,6,8
2015,1361,49,1181,68,0,8,1,7
2015,1234,68,1211,87,0,7,2,5
2015,1320,53,1257,66,0,5,4,1
2015,1438,54,1277,60,0,2,7,-5
2015,1173,66,1328,72,0,11,3,8
2015,1268,59,1452,69,0,4,5,-1
2015,1242,65,1455,78,0,2,7,-5
2015,1332,65,1458,72,0,8,1,7
2015,1462,60,1112,68,0,6,2,4
2015,1452,39,1246,78,0,5,1,4
2015,1455,70,1323,81,0,7,3,4
2015,1314,72,1458,79,0,4,1,3
2015,1428,57,1181,63,0,5,1,4
2015,1417,62,1211,74,0,11,2,9
2015,1301,65,1257,75,0,8,4,4
2015,1328,58,1277,62,0,3,7,-4
2015,1323,66,1246,68,0,3,1,2
2015,1112,78,1458,85,0,2,1,1
2015,1211,52,1181,66,0,2,1,1
2015,1257,70,1277,76,0,4,7,-3
2015,1277,61,1181,81,0,7,1,6
2015,1246,64,1458,71,0,1,1,0
2015,1458,63,1181,68,0,1,1,0
2016,1192,65,1195,96,0,16,16,0
2016,1435,50,1455,70,0,11,11,0
2016,1380,55,1221,59,0,16,16,0
2016,1409,62,1276,67,0,11,11,0
2016,1345,83,1114,85,0,5,12,-7
2016,1403,61,1139,71,0,8,9,-1
2016,1160,67,1163,74,0,8,9,-1
2016,1423,85,1181,93,0,13,4,9
2016,1371,52,1211,68,0,6,11,-5
2016,1151,74,1231,99,0,12,5,7
2016,1233,81,1235,94,0,13,4,9
2016,1122,79,1242,105,0,16,1,15
2016,1392,57,1246,85,0,13,4,9
2016,1138,72,1274,79,0,14,3,11
2016,1195,67,1314,83,0,16,1,15
2016,1425,69,1344,70,0,8,9,-1
2016,1201,69,1428,80,0,14,3,11
2016,1214,45,1438,81,0,16,1,15
2016,1112,55,1455,65,0,6,11,-5
2016,1124,75,1463,79,0,5,12,-7
2016,1143,66,1218,77,0,4,13,-9
2016,1396,70,1234,72,0,10,7,3
2016,1355,74,1268,79,0,12,5,7
2016,1277,81,1292,90,0,2,15,-13
2016,1400,72,1320,75,0,6,11,-5
2016,1276,63,1323,70,0,11,6,5
2016,1167,68,1328,82,0,15,2,13
2016,1221,52,1332,91,0,16,1,15
2016,1452,56,1372,70,0,3,14,-11
2016,1153,76,1386,78,0,9,8,1
2016,1173,51,1393,70,0,7,10,-3
2016,1453,65,1401,92,0,14,3,11
2016,1333,67,1433,75,0,7,10,-3
2016,1421,56,1437,86,0,15,2,13
2016,1338,43,1458,47,0,10,7,3
2016,1451,53,1462,71,0,15,2,13
2016,1463,64,1181,71,0,12,4,8
2016,1428,59,1211,82,0,3,11,-8
2016,1246,67,1231,73,0,4,5,-1
2016,1114,61,1235,78,0,12,4,8
2016,1163,61,1242,73,0,9,1,8
2016,1455,57,1274,65,0,11,3,8
2016,1344,66,1314,85,0,9,1,8
2016,1139,69,1438,77,0,9,1,8
2016,1218,60,1268,73,0,13,5,8
2016,1372,75,1323,76,0,14,6,8
2016,1433,81,1328,85,0,10,2,8
2016,1386,64,1332,69,0,8,1,7
2016,1292,50,1393,75,0,15,10,5
2016,1320,88,1401,92,0,11,3,8
2016,1234,68,1437,87,0,7,2,5
2016,1462,63,1458,66,0,2,7,-5
2016,1268,63,1242,79,0,5,1,4
2016,1401,63,1328,77,0,3,2,1
2016,1181,68,1332,82,0,4,1,3
2016,1274,69,1437,92,0,3,2,1
2016,1231,86,1314,101,0,5,1,4
2016,1458,56,1323,61,0,7,6,1
2016,1211,60,1393,63,0,11,10,1
2016,1235,71,1438,84,0,4,1,3
2016,1332,68,1328,80,0,1,2,-1
2016,1242,59,1437,64,0,1,2,-1
2016,1323,74,1314,88,0,6,1,5
2016,1438,62,1393,68,0,1,10,-9
2016,1393,66,1314,83,0,10,1,9
2016,1328,51,1437,95,0,2,2,0
2016,1314,74,1437,77,0,1,2,-1
2017,1448,88,1243,95,0,11,11,0
2017,1309,66,1291,67,0,16,16,0
2017,1300,63,1413,67,0,16,16,0
2017,1344,71,1425,75,0,11,11,0
2017,1315,82,1112,100,0,15,2,13
2017,1457,64,1139,76,0,13,4,9
2017,1190,65,1196,80,0,13,4,9
2017,1195,80,1199,86,0,14,3,11
2017,1355,46,1211,66,0,16,1,15
2017,1305,73,1235,84,0,12,5,7
2017,1278,72,1292,81,0,5,12,-7
2017,1435,66,1321,68,0,9,8,1
2017,1343,58,1323,60,0,12,5,7
2017,1436,70,1345,80,0,13,4,9
2017,1433,77,1388,85,0,10,7,3
2017,1291,56,1437,76,0,16,1,15
2017,1423,71,1438,76,0,12,5,7
2017,1137,80,1452,86,0,13,4,9
2017,1439,74,1458,84,0,9,8,1
2017,1268,65,1462,76,0,6,11,-5
2017,1371,71,1116,77,0,9,8,1
2017,1308,73,1124,91,0,14,3,11
2017,1243,61,1153,75,0,11,6,5
2017,1407,65,1181,87,0,15,2,13
2017,1413,62,1242,100,0,16,1,15
2017,1297,70,1246,79,0,15,2,13
2017,1240,63,1257,78,0,15,2,13
2017,1329,91,1276,92,0,10,7,3
2017,1274,58,1277,78,0,8,9,-1
2017,1411,64,1314,103,0,16,1,15
2017,1233,77,1332,93,0,14,3,11
2017,1166,72,1348,84,0,6,11,-5
2017,1266,73,1376,93,0,10,7,3
2017,1245,80,1417,97,0,14,3,11
2017,1374,65,1425,66,0,6,11,-5
2017,1173,58,1455,64,0,7,10,-3
2017,1388,60,1112,69,0,7,2,5
2017,1292,65,1139,74,0,12,4,8
2017,1438,39,1196,65,0,5,4,1
2017,1321,73,1211,79,0,8,1,7
2017,1235,76,1345,80,0,5,4,1
2017,1323,71,1452,83,0,5,4,1
2017,1437,62,1458,65,0,1,8,-7
2017,1199,66,1462,91,0,3,11,-8
2017,1425,78,1124,82,0,11,3,8
2017,1277,70,1242,90,0,9,1,8
2017,1455,62,1246,65,0,10,2,8
2017,1257,69,1276,73,0,2,7,-5
2017,1116,65,1314,72,0,8,1,7
2017,1348,72,1332,75,0,11,3,8
2017,1181,81,1376,88,0,2,7,-5
2017,1153,67,1417,79,0,6,3,3
2017,1452,58,1211,61,0,4,1,3
2017,1345,66,1242,98,0,4,1,3
2017,1276,68,1332,69,0,7,3,4
2017,1112,71,1462,73,0,2,11,-9
2017,1458,83,1196,84,0,8,4,4
2017,1417,75,1246,86,0,3,2,1
2017,1139,80,1314,92,0,4,1,3
2017,1124,50,1376,70,0,3,7,-4
2017,1462,59,1211,83,0,11,1,10
2017,1242,60,1332,74,0,1,3,-2
2017,1246,73,1314,75,0,2,1,1
2017,1196,70,1376,77,0,4,7,-3
2017,1376,73,1211,77,0,7,1,6
2017,1332,76,1314,77,0,3,1,2
2017,1211,65,1314,71,0,1,1,0
2018,1254,61,1347,71,0,16,16,0
2018,1417,58,1382,65,0,11,11,0
2018,1113,56,1393,60,0,11,11,0
2018,1300,46,1411,64,0,16,16,0
2018,1439,83,1104,86,0,8,9,-1
2018,1112,68,1138,89,0,4,13,-9
2018,1233,67,1181,89,0,15,2,13
2018,1382,62,1196,77,0,11,6,5
2018,1422,64,1211,68,0,13,4,9
2018,1361,65,1222,67,0,11,6,5
2018,1335,60,1242,76,0,16,1,15
2018,1172,73,1246,78,0,12,5,7
2018,1274,62,1260,64,0,6,11,-5
2018,1285,47,1276,61,0,14,3,11
2018,1355,73,1326,81,0,12,5,7
2018,1328,78,1348,83,0,10,7,3
2018,1301,83,1371,94,0,9,8,1
2018,1460,47,1397,73,0,14,3,11
2018,1372,60,1403,70,0,14,3,11
2018,1347,61,1437,87,0,16,1,15
2018,1158,58,1120,62,0,13,4,9
2018,1116,62,1139,79,0,7,10,-3
2018,1209,53,1153,68,0,15,2,13
2018,1308,68,1155,79,0,12,5,7
2018,1281,54,1199,67,0,8,9,-1
2018,1166,59,1243,69,0,8,9,-1
2018,1455,75,1267,81,0,4,13,-9
2018,1137,78,1277,82,0,14,3,11
2018,1400,83,1305,87,0,10,7,3
2018,1252,66,1314,84,0,15,2,13
2018,1168,48,1345,74,0,15,2,13
2018,1395,52,1393,57,0,6,11,-5
2018,1344,69,1401,73,0,10,7,3
2018,1438,54,1420,74,0,1,16,-15
2018,1293,68,1452,85,0,12,5,7
2018,1411,83,1462,102,0,16,1,15
2018,1348,62,1181,87,0,7,2,5
2018,1326,84,1211,90,0,5,4,1
2018,1371,79,1242,83,0,8,1,7
2018,1138,75,1246,95,0,13,5,8
2018,1397,62,1260,63,0,3,11,-8
2018,1222,63,1276,64,0,6,3,3
2018,1196,66,1403,69,0,6,3,3
2018,1104,58,1437,81,0,9,1,8
2018,1120,53,1155,84,0,4,5,-1
2018,1462,70,1199,75,0,1,9,-8
2018,1420,43,1243,50,0,16,9,7
2018,1153,73,1305,75,0,2,7,-5
2018,1139,73,1345,76,0,10,2,8
2018,1277,53,1393,55,0,3,11,-8
2018,1314,65,1401,86,0,2,7,-5
2018,1267,71,1452,94,0,13,5,8
2018,1211,60,1199,75,0,4,9,-5
2018,1246,58,1243,61,0,5,9,-4
2018,1305,68,1260,69,0,7,11,-4
2018,1401,72,1276,99,0,7,3,4
2018,1393,65,1181,69,0,11,2,9
2018,1155,76,1242,80,0,5,1,4
2018,1345,65,1403,78,0,2,3,-1
2018,1452,78,1437,90,0,5,1,4
2018,1243,62,1260,78,0,9,11,-2
2018,1199,54,1276,58,0,9,3,6
2018,1181,81,1242,85,0,2,1,1
2018,1403,59,1437,71,0,3,1,2
2018,1260,57,1276,69,0,11,3,8
2018,1242,79,1437,95,0,1,1,0
2018,1276,62,1437,79,0,3,1,2
2019,1396,70,1125,81,0,11,11,0
2019,1341,76,1192,82,0,16,16,0
2019,1385,65,1113,74,0,11,11,0
2019,1300,74,1295,78,0,16,16,0
2019,1308,77,1120,78,0,12,5,7
2019,1393,69,1124,78,0,8,9,-1
2019,1305,61,1196,70,0,7,10,-3
2019,1436,69,1199,76,0,13,4,9
2019,1192,49,1211,87,0,16,1,15
2019,1318,53,1242,87,0,13,4,9
2019,1101,44,1246,79,0,15,2,13
2019,1463,74,1261,79,0,14,3,11
2019,1125,77,1268,79,0,11,6,5
2019,1285,55,1276,74,0,15,2,13
2019,1133,65,1277,76,0,15,2,13
2019,1257,76,1278,86,0,7,10,-3
2019,1266,64,1293,83,0,5,12,-7
2019,1330,48,1345,61,0,14,3,11
2019,1388,57,1437,61,0,11,6,5
2019,1371,68,1459,84,0,10,7,3
2019,1113,74,1138,91,0,11,6,5
2019,1295,62,1181,85,0,16,1,15
2019,1209,55,1222,84,0,14,3,11
2019,1153,72,1234,79,0,7,10,-3
2019,1280,76,1251,80,0,5,12,-7
2019,1233,73,1314,88,0,16,1,15
2019,1235,59,1326,62,0,6,11,-5
2019,1279,72,1328,95,0,8,9,-1
2019,1458,54,1332,72,0,5,12,-7
2019,1159,70,1397,77,0,15,2,13
2019,1297,57,1403,72,0,14,3,11
2019,1243,64,1414,70,0,4,13,-9
2019,1433,58,1416,73,0,8,9,-1
2019,1205,56,1438,71,0,16,1,15
2019,1387,52,1439,66,0,13,4,9
2019,1429,61,1449,78,0,8,9,-1
2019,1242,75,1120,89,0,4,5,-1
2019,1293,62,1199,90,0,12,4,8
2019,1124,71,1211,83,0,9,1,8
2019,1459,56,1246,62,0,7,2,5
2019,1268,67,1261,69,0,6,3,3
2019,1196,49,1276,64,0,10,2,8
2019,1278,50,1277,70,0,10,2,8
2019,1437,61,1345,87,0,6,3,3
2019,1416,76,1181,77,0,9,1,8
2019,1326,59,1222,74,0,11,3,8
2019,1449,59,1314,81,0,9,1,8
2019,1414,54,1332,73,0,13,12,1
2019,1234,77,1397,83,0,10,2,8
2019,1138,58,1403,78,0,6,3,3
2019,1328,51,1438,63,0,9,1,8
2019,1251,58,1439,67,0,12,4,8
2019,1199,58,1211,72,0,4,1,3
2019,1397,94,1345,99,0,2,3,-1
2019,1276,44,1403,63,0,2,3,-1
2019,1332,49,1438,53,0,12,1,11
2019,1314,80,1120,97,0,1,5,-4
2019,1439,73,1181,75,0,4,1,3
2019,1222,58,1246,62,0,3,2,1
2019,1261,63,1277,80,0,3,2,1
2019,1211,69,1403,75,0,1,3,-2
2019,1345,75,1438,80,0,3,1,2
2019,1246,71,1120,77,0,2,5,-3
2019,1181,67,1277,68,0,1,2,-1
2019,1277,51,1403,61,0,2,3,-1
2019,1120,62,1438,63,0,5,1,4
2019,1403,77,1438,85,0,3,1,2
